	0
TACGGAGGATGCGAGCGTTATCCGGATTTATTGGGTTTAAAGGGTGCGTAGGCGGACTGTCAAGTCAGCGGTAAAATTGAGAGGCTCAACCTCTTCCCGCCGTTGAAACTGGTGGTCTTGAGTGGATGAGAAGTACGCGGAATGCGTGGT	False
TACGGAGGATGCGAGCGTTATCCGGATTTATTGGGTTTAAAGGGTGCGTAGGCGGACAGTTAAGTCAGCGGTAAAATTGAGAGGCTCAACCTCTTCCCGCCGTTGAAACTGATTGTCTTGAGTGGGCGAGAAGTATGCGGAATGCGTGGT	False
TACGTAGGTGGCGAGCGTTATCCGGAATGATTGGGCGTAAAGGGTGCGCAGGCGGTCCTGCAAGTCTGGAGTGAAACGCATGAGCTCAACTCATGCATGGCTTTGGAAACTGGAGGACTGGAGAGCAGGAGAGGGCGGTGGAACTCCATG	False
TACGTAGGTGGCAAGCGTTATCCGGAATTATTGGGCGTAAAGAGGGAGCAGGCGGCAGCAAAGGTCTGTGGTGAAAGACTGAAGCTTAACTTCAGTAAGCCATAGAAACCGGGCAGCTAGAGTGCAGGAGAGGATCGTGGAATTCCATGT	True
TACGTAGGGGGCAAGCGTTATCCGGATTTACTGGGTGTAAAGGGGGCGCAGACGGCGATGCAAGCCAGGAGTGAAAGCCCGGGGCCCAACCCCGGGACTGCTCTTGGAACTGCGTGGCTGGAGTGCAGGAGGGGCAGGCGGAATTCCTGG	True
TACGGAGGATGCGAGCGTTATCCGGATTTATTGGGTTTAAAGGGTGCGTAGGCGGTCCGTTAAGTCAGCGGTAAAATTGCGGGGCTCAACCCCGTCGAGCCGTTGAAACTGGCAGACTTGAGTTGGCGAGAAGTACGCGGAATGCGCGGT	False
TACGTATGGAGCAAGCGTTATCCGGATTTACTGGGTGTAAAGGGAGCGTAGGCGGCCTGCCAAGTCTGATGTGAAATACCGGGGCTCAACCCCGGGGCTGCATTGGAAACTGGCAGGCTGGAGTGTCGGAGAGGCAGGCGGAATTCCTAG	True
TACGTAGGTGGCAAGCGTTATCCGGATTTACTGGGTGTAAAGGGCGTGTAGGCGGGAAAGCAAGTCAGATGTGAAAACCATGGGCTCAACCTGTGGCCTGCATTTGAAACTGTTTTTCTTGAGTACTGGAGAGGCAGACGGAATTCCTAG	True
TACGGAGGATGCGAGCGTTATCCGGATTTATTGGGTTTAAAGGGTGCGCAGGCGGACTCTCAAGTCAGCGGTCAAATCGCGGGGCTCAACCCCGTTCCGCCGTTGAAACTGGGAGCCTTGAGTGCGCGAGAAGTAGGCGGAATGCGTGGT	True
TACGTAGGGGGCAAGCGTTATCCGGATTTACTGGGTGTAAAGGGAGCGTAGACGGTGATGCAAGTCTGAAGTGAAAGGCGGGGGCTCAACCCCCGGACTGCTTTGGAAACTGTATGACTGGAGTGCAGGAGAGGTAAGTGGAATTCCTAG	False
TACGTAGGTCCCGAGCGTTGTCCGGATTTATTGGGCGTAAAGCGAGCGCAGGTGGTTTATTAAGTCTGGTGTAAAAGGCAGTGGCTCAACCATTGTATGCATTGGAAACTGGTAGACTTGAGTGCAGGAGAGGAGAGTGGAATTCCATGT	True
TACGTAGGGGGCAAGCGTTATCCGGATTTACTGGGTGTAAAGGGAGCGTAGACGGCCAGACAAGTCTGAAGTGAAAATCCAGCGCTTAACGTTGGAAGTGCTTTGGAAACTGCCGGGCTAGAGTGCAGGAGGGGCAGGCGGAATTCCTAG	False
TACGTAGGTGGCAAGCGTTATCCGGATTTATTGGGTGTAAAGGGCGTGTAGGCGGGAATGCAAGTCAGATGTGAAAACTCAGGGCTCAACCCTGAGCCTGCATTTGAAACTGTATTTCTTGAGTGCTGGAGAGGCAATCGGAATTCCGTG	True
TACGTAGGTGGCAAGCGTTGTCCGGATTTACTGGGTGTAAAGGGCGTGTAGCCGGGCCGGCAAGTCAGATGTGAAATCCCAAGGCTCAACCTTGGAACTGCATTTGAAACTGTTGGTCTTGAGTATCGGAGAGGCAGGCGGAATTCCTAG	True
TACGTAGGGGGCAAGCGTTATCCGGATTTACTGGGTGTAAAGGGAGCGTAGACGGCAGCGCAAGTCTGGAGTGAAATCCCATGGCTTAACCATGGAACTGCTTTGGAAACTGTGCAGCTGGAGTGCAGGAGAGGTAAGCGGAATTCCTAG	False
TACGTAGGGGGCAAGCGTTATCCGGATTTACTGGGTGTAAAGGGAGCGTAGGCGGTGCAGCAAGTCAGAAGTGAAAGCCCGGGGCTCAACTCCGGGACTGCTTTTGAAACTGTTGAACTAGATTGCAGGAGAGGTAAGTGGAATTCCTAG	True
TACGTAGGTGGCAAGCGTTATCCGGATTTACTGGGTGTAAAGGGCGTGTAGGCGGGACTGCAAGTCAGATGTGAAAACCACGGGCTCAACCTGTGGCCTGCATTTGAAACTGTAGTTCTTGAGTACTGGAGAGGCAGACGGAATTCCTAG	False
TACGTAGGTGGCAAGCGTTGTCCGGATTTACTGGGTGTAAAGGGCGTGTAGCCGGGTTGACAAGTCAGATGTGAAATCCTGCGGCTTAACCGCAGAACTGCATTTGAAACTGTTGATCTTGAGTACTGGAGAGGCAGACGGAATTCCTAG	False
TACGTAGGTGGCAAGCGTTGTCCGGATTTACTGGGTGTAAAGGGCGTGTAGCCGGGCTGACAAGTCAGATGTGAAATCCGGGGGCTCAACCCCCGAACTGCATTTGAAACTGTTGGTCTTGAGTATCGGAGAGGCAGGCGGAATTCCTAG	True
TACGGAGGATGCGAGCGTTATCCGGATTTATTGGGTTTAAAGGGTGCGCAGGCGGGCTGTCAAGTCAGCGGTAAAATTGAGAGGCTCAACCTCTTCGAGCCGTTGAAACTGGCGGTCTTGAGTGAGCGAGAAGTACGCGGAATGCGTGGT	True
TACGTAGGTGGCAAGCGTTATCCGGATTTACTGGGTGTAAAGGGCGTGTAGGCGGGGAAGCAAGTCAGATGTGAAAACCACGGGCTCAACCTGTGGCCTGCATTTGAAACTGTTTTTCTTGAGTGCTGGAGAGGCAATCGGAATTCCGTG	False
TACGTAGGGGGCAAGCGTTATCCGGATTTACTGGGTGTAAAGGGAGCGTAGACGGTTAAGCAAGTCTGAAGTGAAAGGCGGGGGCTCAACCCCCGGACTGCTTTGGAAACTGTATGACTGGAGTGCAGGAGAGGTAAGTGGAATTCCTAG	False
TACGTAGGGAGCAAGCGTTGTCCGGAATTACTGGGTGTAAAGGGAGCGTAGGCGGGGATGCAAGTTGGGTGTCAAAACTACCGGCTCAACCGATAGTCGCACTCAAAACTGCAGCTCTTGAGTGAAGTAGAGGCAGGCGGAATTCCTAGT	True
TACGTAGGGGGCAAGCGTTATCCGGATTTACTGGGTGTAAAGGGAGCGTAGACGGTGATGCAAGTCAGAAGTGAAAGCCCGCGGCTCAACTGCGGGACTGCTTTTGAAACTGTATAACTAGAGTGCAGGAGAGGTAAGCGGAATTCCTAG	True
TACGTAGGGGGCAAGCGTTATCCGGATTTACTGGGTGTAAAGGGAGCGTAGACGGTCCTGCAAGCCAGATGTGAAAGCCCGGGGCTCAACCCCGGGACTGCATTTGGAACTGTAAGGCTAGAGTGTCGGAGAGGCAGGCGGAATTCCTAG	True
TACGTAGGGGGCAAGCGTTATCCGGATTTACTGGGTGTAAAGGGAGCGTAGACGGCAGGGCAAGTCTGGAGTGAAAGGCAGGGGCCCAACCCCTGGACTGCTCTGGAAACTGTCCGGCTGGAGTGCAGGAGAGGTAAGTGGAATTCCTAG	False
TACGTAGGTGGCAAGCGTTATCCGGATTTACTGGGTGTAAAGGGCGTGTAGGCGGGAGAGCAAGTCAGACGTGAAATTCCAGGGCTCAACCCTGGAACTGCGTTTGAAACTGTTCTTCTTGAGTGATGGAGAGGCAGGCGGAATTCCGTG	True
TACGTAGGGAGCGAGCGTTGTCCGGAATTACTGGGTGTAAAGGGAGCGTAGGCGGGCGAGAAAGTTGAATGTTAAATCTACCGGCTTAACTGGTAGCTGCGTTCAAAACTTCTTGTCTTGAGTGAAGTAGAGGCAGGCGGAATTCCTAGT	True
TACGTAGGGGGCAAGCGTTATCCGGATTTACTGGGTGTAAAGGGAGCGTAGACGGCGTGCCAAGTCTGATGTGAAAGGCCGGGGCTCAACCCCGGGACTGCATTGGAAACTGGCATGCTAGAGTGCCGGAGGGGCAAGCGGAATTCCTAG	False
TACGTAGGGGGCAAGCGTTATCCGGATTTACTGGGTGTAAAGGGAGCGTAGACGGCGTGCCAAGTCTGATGTGAAAGGCCGGGGCTCAACCCCGGGACTGCATTGGAAACTGGCATGCTGGAGTGCCGGAGGGGCAAGCGGAATTCCTAG	False
TACGTAGGGGGCAAGCGTTATCCGGATTTACTGGGTGTAAAGGGAGCGTAGGCGGCGATGCAAGTCAGAAGTGAAAGCCCGGGGCTCAACTCCGGGACTGCTTTTGAAACTGTGTTGCTAGATTGCAGGAGAGGTAAGTGGAATTCCTAG	False
TACGTAGGGGGCAAGCGTTATCCGGATTTACTGGGTGTAAAGGGAGCGTAGACGGCAATGCAAGCCAGATGTGAAAACCCGCAGCTCAACTGGGGGAGTGCATTTGGAACTGTGTAGCTGGAGTGCAGGAGAGGTAAGCGGAATTCCTGG	True
TACGTAGGTGGCGAGCGTTATCCGGAATTATTGGGCGTAAAGAGGGAGCAGGCGGCAGCTAAGGTCTGCGGTGAAAGCCCGAAGCTAAACTTCGGTAAGCCGTGGAAACCGAGCAGCTAGAGTGCAGTAGAGGATCGTGGAATTCCATGT	True
TACGTAGGTGGCAAGCGTTATCCGGATTTACTGGGTGTAAAGGGCGTGTAGGCGGGAGTGCAAGTCAGATGTGAAAACTATGGGCTCAACCCATAGCCTGCATTTGAAACTGTACTTCTTGAGTGCTGGAGAGGCAATCGGAATTCCGTG	False
TACGTATGGTGCAAGCGTTATCCGGATTTACTGGGTGTAAAGGGAGCGCAGGCGGCACGGCAAGCCTGATGTGAAAGCCCGCGGCCCAACCGCGGGACTGCATTGGGAACTACCGGGCTGGAGTGCCGGAGAGGTAGGCGGAATTCCTAG	True
TACGTAGGGGGCGAGCGTTATCCGGATTCACTGGGTGTAAAGGGAGCGTAGACGGCCATGCAAGCCAGGGGTGAAAGCCCGGGGCCCAACCCCGGGACTGCCCTTGGAACTGCATGGCTGGAGTGCGGGAGGGGCAGGCGGAATTCCTGG	True
TACGTAGGTGGCAAGCGTTGTCCGGATTTATTGGGCGTAAAGCGAGTGCAGGCGGTTCAATAAGTCTGATGTGAAAGCCTTCGGCTCAACCGGAGAATTGCATCAGAAACTGTTGAACTTGAGTGCAGAAGAGGAGAGTGGAACTCCATG	True
TACGTAGGGGGCAAGCGTTATCCGGATTTACTGGGTGTAAAGGGAGCGTAGACGGCGATGCAAGTCTGAAGTGAAAGCCCGGGGCTCAACCCCGGGACTGCTTTGGAAACTGTATGGCTGGAGTGCTGGAGAGGCAAGCGGAATTCCTAG	True
TACGTAGGGGGCAAGCGTTATCCGGATTTACTGGGTGTAAAGGGAGCGTAGACGGCTGTGCAAGCCAGATGTGAAAGCCCGGGGCTCAACCCCGGGACTGCATTTGGAACTGCGTGGCTTGAGTGTCGGAGAGGCAGGCGGAATTCCTAG	False
TACGTAGGGAGCGAGCGTTGTCCGGAATTACTGGGTGTAAAGGGAGCGTAGGCGGGACTGCAAGTTGGGTGTCAAATCTACCGGCTCAACCGGTAGCCGCACTCAAAACTGCAGTTCTTGAGTGAAGTAGAGGCAGGCGGAATTCCTAGT	True
TACGTAGGTGGCAAGCGTTGTCCGGATTTACTGGGTGTAAAGGGCGTGCAGCCGGGTTTATAAGTCAGATGTGAAATCCCGCGGCTCAACCGCGGAACTGCATTTGAAACTGTAGATCTTGAGTACTGGAGAGGCAGGCGGAATTCCTAG	False
TACGTAGGGAGCAAGCGTTGTCCGGATTTACTGGGTGTAAAGGGTGCGTAGGCGGCTTTGCAAGTCAGAAGTGAAATCTATGGGCTTAACCCATAAACTGCTTTTGAAACTGCAGGGCTTGAGTGAAGTAGAGGTAGGCGGAATTCCCGG	False
TACGTAGGTGGCAAGCGTTGTCCGGATTTACTGGGTGTAAAGGGCGTGCAGCCGGAGAGACAAGTCAGATGTGAAATCCACGGGCTCAACCCGTGAACTGCATTTGAAACTGTTTCCCTTGAGTGTCGGAGAGGTCATCGGAATTCCTTG	True
TACGTAGGGGGCAAGCGTTATCCGGATTCACTGGGTGTAAAGGGAGCGTAGACGGCGACGCAAGTCTGGAGTGAAAGCCCGGGGCCCAACCCCGGGACTGCTCTGGAAACTGCGTCGCTGGAGTACGGGAGGGGCAGGCGGAATTCCTGG	False
TACGTAGGGGGCAAGCGTTATCCGGATTTACTGGGTGTAAAGGGAGCGTAGACGGCTTGGCAAGCCAGATGTGAAAGGCTGGGGCTCAACCCCAGGACTGCATTTGGAACTGTCATGCTAGAGTGTCGGAGAGGCAGGCGGAATTCCTAG	True
TACGTAGGTGGCAAGCGTTATCCGGATTTACTGGGTGTAAAGGGCGTGTAGGCGGGACTGCAAGTCAGATGTGAAAATTATGGGCTCAACCCATAACCTGCATTTGAAACTGTAGTTCTTGAGTGATGGAGAGGCAGGCGGAATTCCGTG	True
TACGTAGGGAGCAAGCGTTGTCCGGAATTACTGGGTGTAAAGGGAGCGTAGGCGGGATGGCAAGTTGGGTGTTAAATCTACCGGCTCAACTGGTAGTCGCACTCAAAACTGCTATTCTTGAGTGAAGTAGAGGCAGGCGGAATTCCTAGT	False
TACGTAGGGGGCGAGCGTTATCCGGATTCATTGGGCGTAAAGCGCGCGTAGGCGGCCAGTTAGGTCGGGAGTCAAATTTCGGGGCTCAACCCCGTCTCGCTCCCGATACCGGCTGGCTTGAGTGTGGTAGGGGAAGGCGGAATTCCCGGT	True
TACGTAGGTGGCAAGCGTTGTCCGGATTTACTGGGTGTAAAGGGCGTGCAGCCGGGAGTGCAAGTCAGATGTGAAATCCCGCGGCTCAACCGCGGAACTGCATTTGAAACTGTGCTTCTTGAGTGCTGGAGAGGCAGACGGAATTCCTAG	True
TACGTAGGGGGCAAGCGTTATCCGGATTTACTGGGTGTAAAGGGAGCGTAGACGGCAGAGCAAGTCTGAAGTGAAAGCCCGCGGCCCAACTGCGGGACTGCTTTGGAAACTGCCCGGCTAGAGTGCTGGAGAGGTAAGCGGAATTCCTAG	False
TACGTAGGGGGCGAGCGTTATCCGGATTCACTGGGTGTAAAGGGAGCGTAGACGGCCATGCAAGCCAGGGGTGAAAGCCCGGGGCCCAACCCCGGGACTGCCCTTGGAACTGTGCGGCTAGAGTGCGGGAGGGGCAGGCGGAATTCCTGG	True
TACGTAGGGGGCAAGCGTTATCCGGATTTACTGGGTGTAAAGGGAGCGTAGACGGCAGCGCAAGTCTGGAGTGAAATCCCATGGCTTAACCATGGAACTGCTTTGGAAACTGTGCAGCTAGAGTGCAGGAGAGGTAAGCGGAATTCCTAG	True
TACGTAGGGAGCGAGCGTTGTCCGGAATTACTGGGTGTAAAGGGTGCGTAGGCGGCCTTGCAAGTCAGGCGTGAAAACCATGGGCTCAACCCGTGGACTGCGTTTGAAACTGTGAGGCTTGAGTGAAGTAGAGGTAGGCGGAATTCCCGG	False
TACGTAGGGGGCAAGCGTTATCCGGATTTACTGGGTGTAAAGGGAGCGTAGACGGTGATGCAAGTCAGAAGTGAAAGCCCGCGGCTCAACTGCGGGACTGCTTTTGAAACTGTATGACTAGAGTGCAGGAGAGGTAAGCGGAATTCCTAG	True
TACGTATGGTGCAAGCGTTATCCGGAATGACTGGGTGTAAAGGGAGCGTAGACGGTTGTACAAGTCTGATGTGAAAGCCCACGGCTCAACTGTGGGAGTGCATTGGAAACTGTAGAACTAGAGTATCGGAGAGGCAAGTGGAATTCCTAG	False
TACGTAGGGGGCAAGCGTTATCCGGATTTACTGGGTGTAAAGGGAGCGCAGACGGCAGTGCAAGTCTGGAGTGAAAGCCCGGGGCCCAACCCCGGAACTGCTCTGGAAACTGTGCGGCTAGAGTACTGGAGGGGCAGGCGGAATTCCTAG	False
TACGTAGGGGGCAAGCGTTATCCGGAATTATTGGGCGTAAAGAGTACGTAGGTGGCAACCTAAGCGCAGGGTTTAAGGCAATGGCTCAACCATTGTTCGCCCTGCGAACTGGGATGCTTGAGTGCAGGAGAGGAAAGCGGAATTCCTAGT	True
TACGTAGGGGGCAAGCGTTATCCGGATTTACTGGGTGTAAAGGGAGCGTAGACGGCGTGCCAAGTCTGGTGTGAAAGGCCGGGGCTCAACCCCGGGACTGCATTGGAAACTGGCATGCTGGAGTGCCGGAGGGGCAAGCGGAATTCCTAG	True
TACGTATGGGGCAAGCGTTATCCGGATTTACTGGGTGTAAAGGGAGCGTAGGCGGCGGGGCAAGCCTGATGTGAAAGCCCGGGGCTCAACCCCGGGACTGCATTGGGAACTGCCCTGCTGGAGTGCCGGAGGGGCAGGCGGAATTCCTAG	False
TACGTAGGTGGCAAGCGTTGTCCGGATTTACTGGGTGTAAAGGGCGTGCAGCCGGGAAGACAAGTCAGATGTGAAATCCCGCGGCTCAACCGCGGAACTGCATTTGAAACTGTTTTTCTTGAGTACCGGAGAGGTCATCGGAATTCCTTG	False
TACGTAGGGGGCAAGCGTTATCCGGATTTACTGGGTGTAAAGGGAGCGTAGACGGCGCTGCAAGTCCGGAGTGAAAGCCCATGGCTTAACCATGGTACTGCTCTGGAAACTGTGGAGCTTGAGTGCGGGAGGGGCAGGCGGAATTCCTAG	True
TACGTAGGGGGCAAGCGTTATCCGGATTTACTGGGTGTAAAGGGAGCGTAGACGGTGATGCAAGTCAGAAGTGAAAGCCCGCGGCTCAACTGCGGGACTGCTTTTGAAACTGTATGACTGGAGTGCAGGAGAGGTAAGCGGAATTCCTAG	True
TACGTAGGGGGCAAGCGTTATCCGGAATTACTGGGTGTAAAGGGAGAGTAGGCGGCAAGGTAAGCGATATGTGAAAGCCTTAAGCTTAACTTAAGGATGGCATAACGAACTATCTAGCTAGAGTACAGGAGAGGAAAGCGGAATTCCTAG	False
TACGTAGGTGGCAAGCGTTGTCCGGATTTACTGGGTGTAAAGGGCGTGTAGCCGGGCTGACAAGTCAGATGTGAAATTCCGGGGCTCAACCCCGGACCTGCATTTGAAACTGTTGGTCTTGAGTATCGGAGAGGCAGGCGGAATTCCTAG	False
TACGTAGGGGGCGAGCGTTATCCGGATTCACTGGGTGTAAAGGGAGCGTAGACGGCCAAGCAAGCCAGGGGTGAAAGCCCGGGGCCCAACCCCGGGACTGCCCTTGGAACTGCATGGCTGGAGTGCGGGAGGGGCAGGCGGAATTCCTGG	False
TACGTAGGGGGCAAGCGTTATCCGGATTTACTGGGTGTAAAGGGAGCGTAGACGGCAGTGCAAGTCTGAAGTGAAAGGCAAGGGCTCAACCCTTGGACTGCTTTGGAAACTGTGCTGCTGGAGTGTCGGAGAGGCAAGTGGAATTCCTAG	False
TACGTAGGGGGCAAGCGTTATCCGGAATTACTGGGTGTAAAGGGAGAGTAGGCGGCAAGGTAAGCGATATGTGAAAGCCTTAGGCTTAACCAAAGGATTGCATAACGAACTATCTAGCTAGAGTACAGGAGAGGAAAGCGGAATTCCTAG	False
TACGTAGGGGGCAAGCGTTATCCGGATTTACTGGGTGTAAAGGGAGCGTAGACGGCAGCGCAAGTCTGGAGTGAAATGCCGGGGCCCAACCCCGGAACTGCTTTGGAAACTGTGCAGCTCGAGTGCAGGAGAGGTAAGCGGAATTCCTAG	True
TACGTAGGGGGCAAGCGTTATCCGGATTCACTGGGTGTAAAGGGAGCGTAGACGGCGACGCAAGTCTGGAGTGAAAGCCCGGGGCCCAACCCCGGGACTGCTCTGGAAACTGCGGCGCTGGAGTACGGGAGGGGCAGGCGGAATTCCTGG	True
TACGTAGGGGGCAAGCGTTATCCGGATTTACTGGGTGTAAAGGGAGCGTAGACGGCAATACAAGTCGGAAGTGAAATACCCGGGCTCAACCTGGGAACTGCTTTGGAAACTGTATGGCTGGAGTGCTGGAGAGGTAAGCGGAATTCCTAG	False
TACGTAGGTGGCGAGCGTTGTCCGGAATTACTGGGTGTAAAGGGAGCGTAGGCGGGATATTAAGTTGAATGTATAAACTACCGGCTTAACCGATAGAAGCGTTCAAAACTGATATTCTTGAGTGAAGTAGAGGCAGGCGGAATTCCTAGT	False
TACGTAGGGAGCGAGCGTTGTCCGGAATTACTGGGTGTAAAGGGAGCGTAGGCGGGCTTGTAAGTTGAATGTCTAATCCACCGGCTCAACCGGTGATCGCGTTCAAAACTGCAGGTCTTGAGTGAAGTAGAGGCAGGCGGAATTCCTAGT	False
TACGTAGGGGGCAAGCGTTATCCGGATTTACTGGGTGTAAAGGGAGCGTAGACGGTGATGCAAGTCAGAAGTGAAAGCCCGGGGCTCAACTCCGGGACTGCTTTTGAAACTGTGTGACTGGAGTGCAGGAGAGGTAAGCGGAATTCCTGG	False
TACGTATGGAGCAAGCGTTATCCGGATTTACTGGGTGTAAAGGGAGCGCAGGCGGTCTGGCAAGTCTGATGTGAAAGGCCGGGGCTCAACTCCGGGACTGCATTGGAAACTGTCAGACTGGAGTGTCGGAGAGGTAAGCGGAATTCCTAG	False
TACGTAGGTGGCAAGCGTTGTCCGGATTTACTGGGTGTAAAGGGCGTGTAGCCGGGAAGGCAAGTCAGATGTGAAATCCGGAGGCTCAACCTCCGAATTGCATTTGAAACTGTTTTTCTTGAGTACTGGAGAGGCAGACGGAATTCCTTG	False
TACGTATGGAGCAAGCGTTATCCGGATTTACTGGGTGTAAAGGGAGCGTAGGCGGCTCTGTAAGTCTGATGTGAAAATTTGGGGCTCAACCCCAAACGTGCATTGGAAACTGCAGGGCTTGAGTGCCGGAGAGGCAGGCGGAATTCCTAG	True
TACGTAGGTGGCAAGCGTTATCCGGAATGATTGGGCGTAAAGGGTGCGTAGGCGGCAAAATAAGTCTGAAGTAAAAGGCGTTGGCTCAACCAACGTAAGCTTTGGAAACTGTTAAGCTAGCGTGCAGGAGAGGTTAGTGGAATTCCATGT	False
TACGTATGGAGCAAGCGTTATCCGGATTTACTGGGTGTAAAGGGAGCGCAGGCGGTCTGGCAAGTCTGATGTGAAAGGCCGGGGCTCAACCCCGGGACTGCATTGGAAACTGTCAGACTGGAGTGTCGGAGAGGTAAGCGGAATTCCTAG	True
TACGTAGGGAGCAAGCGTTGTCCGGAATTACTGGGCGTAAAGGGCGCGTAGGTGGGCGCTTAAGTCAGGTGTGAAAACTCCGGGCTCAACCTGGAGACTGCACTTGAAACTGGGTGTCTTGAGGGCAGGAGAGGAAAGTGGAATTCCTAG	True
TACGTAGGTGGCGAGCGTTATCCGGATTTACTGGGTGTAAAGGGCGTGTAGGCGGGAGAGCAAGTCAGATGTGAAAACTACAGGCTTAACCTGTAGCCTGCATTTGAAACTGTTCTTCTTGAGTGATGGAGAGGCAGGCGGAATTCCTAG	True
TACGTAGGGGGCAAGCGTTATCCGGATTTACTGGGTGTAAAGGGAGCGTAGACGGCGCGGCAAGTCTGAAGTGAAAGGCAGGGGCTTAACCCCTGAACTGCTTTGGAAACTGCCATGCTAGAGTGCTGGAGAGGTAAGTGGAATTCCTAG	False
TACGTATGGTGCAAGCGTTATCCGGATTTACTGGGTGTAAAGGGAGCGCAGGCGGTTCTGCAAGTCTGATGTGAAAGCCCGGGGCTCAACCGCGGGACTGCATTGGAAACTGCGGGACTGGAGTGTCGGAGGGGTAAGCGGAATTCCTGG	False
TACGTAGGGGGCAAGCGTTATCCGGATTTACTGGGTGTAAAGGGAGCGTAGGTGGCATGGCAAGCCAGAAGTGAAAACCCGGGGCTTAACCCCGCGGATTGCTTTTGGAACTGTCAGGCTGGAGTGCAGGAGGGGCAGGCGGAATTCCTG	False
TACGTAGGGGGCAAGCGTTATCCGGATTTACTGGGTGTAAAGGGAGCGTAGGCGGTGATGCAAGTCAGAAGTGAAAGCCCGCAGCTCAACTGCGGGACTGCTTTTGAAACTGTATGACTAGATTGCAGGAGAGGTAAGTGGAATTCCTAG	True
TACGTAGGGGGCAAGCGTTATCCGGAATTACTGGGTGTAAAGGGTGAGTAGGCGGCATGGTAAGCCAGATGTGAAAGCCTTGGGCTTAACCCGAGGATTGCATTTGGAACTATCAAGCTAGAGTACAGGAGAGGAAAGCGGAATTCCTAG	False
TACGTAGGGGGCAAGCGTTATCCGGATTTACTGGGTGTAAAGGGAGCGTAGACGGTATGGCAAGTCTGATGTGAAAACCCGGGGCTCAACCCCGGGACTGCATTGGAAACTGTCGGACTAGAGTGTCGGAGAGGCAAGTGGAATTCCTAG	False
TACGTAGGGGGCAAGCGTTATCCGGATTTACTGGGTGTAAAGGGAGCGTAGACGGCGATGCAAGCCAGATGTGAAAGCCCGGGGCTCAACCCCGGGACTGCATTTGGAACTGTGTGGCTGGAGTGTCGGAGAGGCAGGCGGAATTCCTAG	False
TACGTAGGGGGCGAGCGTTATCCGGATTTACTGGGTGTAAAGGGAGCGTAGACGGCGTCGCAAGTCTGAAGTGAAAGCCCGTGGCTCAACCGCGGAACCGCTTTGGAAACTGCGAGGCTGGAGTGCTGGAGAGGTAAGCGGAATTCCTGG	False
TACGTAGGGGGCAAGCGTTATCCGGATTTACTGGGTGTAAAGGGAGCGTAGACGGAATTGCAAGTCTGATGTGAAAATCCGGGGCCCAACCCCGGAACTGCATTGGAAACTGTATTTCTAGAGTGTCGGAGAGGCAAGTGGAATTCCTGG	False
TACGTAGGGGGCAAGCGTTATCCGGATTTACTGGGTGTAAAGGGAGCGTAGACGGTTGTGCAAGTCTGAAGTGAAAGCCCGCGGCTCAACTGCGGAACGGCTTTGGAAACTGTGTAACTGGAGTGCTGGAGAGGTAAGCGGAATTCCTGG	True
TACGTAGGTGGCAAGCGTTGTCCGGATTTACTGGGTGTAAAGGGCGTGCAGCCGGAGAGACAAGTCAGATGTGAAATCCGCAGGCTCAACCTGCGAACTGCATTTGAAACTGTTTCCCTTGAGTATCGGAGAGGTCATCGGAATTCCTAG	True
TACGTAGGTGGCAAGCGTTGTCCGGATTTATTGGGCGTAAAGCGAGCGCAGGCGGTTTCTTAAGTCTGATGTGAAAGCCCCCGGCTCAACCGGGGAGGGTCATTGGAAACTGGGAGACTTGAGTGCAGAAGAGGAGAGTGGAATTCCATG	False
TACGTAGGTGGCAAGCGTTGTCCGGATTTACTGGGTGTAAAGGGCGTGCAGCCGGAGAGACAAGTCAGATGTGAAATCCACGGGCTCAACCCGTGAACTGCATTTGAAACTGTTTCCCTTGAGTGTCGGAGAGGTAATCGGAATTCCTTG	False
TACGTAGGGGGCAAGCGTTATCCGGATTTACTGGGTGTAAAGGGAGCGTAGACGGCAATACAAGTCGGAAGTGAAATACCCGGGCTTAACCTGGGAACTGCTTTGGAAACTGTATGGCTGGAGTGCTGGAGAGGTAAGCGGAATTCCTAG	False
TACGTAGGGGGCAAGCGTTATCCGGATTTACTGGGTGTAAAGGGAGCGTAGACGGCAGCGCAAGTCCGAAGTGAAAGCCCGGGGCCCAACCCCGGGACTGCTTTGGAAACTGTGAAGCTGGAGTGCGGGAGGGGCAGGCGGAATTCCTGG	False
TACGTAGGGAGCGAGCGTTGTCCGGAATTACTGGGTGTAAAGGGAGCGTAGGCGGGGATGCAAGTTGGATGTTTAAACTATCGGCTCAACCGGTAATTGCAACCAAAACTGCAACTCTTGAGTGAAGTAGAGGCAGGCGGAATTCCTAGT	True
TACGTAGGGGGCAAGCGTTATCCGGATTTACTGGGTGTAAAGGGAGCGTAGACGGCTGTGCAAGTCAGAAGTGAAAGCCCGGGGCTCAACCGCGGGACTGCTTTTGAAACTGTGTAGCTAGAGTGCAGGAGAGGTAAGTGGAATTCCTAG	False
TACGTATGGGGCAAGCGTTATCCGGATTTACTGGGTGTAAAGGGAGCGTAGGCGGCAGGGCAAGCCTGATGTGAAAGCCCGGGGCTCAACCCCGGGACTGCATTGGGAACTGCCCTGCTGGAGTGCCGGAGGGGCAGGCGGAATTCCTAG	False
TACGTAGGGGGCAAGCGTTATCCGGATTTACTGGGTGTAAAGGGAGCGTAGACGGCAGAGCAAGTCCGGAGTGAAAGCCCGGGGCCCAACCCCGGGACTGCTCTGGAAACTGTTAAGCTGGAGTGCGGGAGGGGCAGGCGGAATTCCTGG	False
TACGTAGGGAGCAAGCGTTGTCCGGATTTACTGGGTGTAAAGGGTGCGTAGGCGGCCCTGCAAGTCAGAAGTGAAATCCATGGGCTTAACCCGTGAACCGCTTTTGAAACTGTAGGGCTTGAGTGAAGTAGAGGCAGGCGGAATTCCCGG	True
TACGTAGGGGGCAAGCGTTATCCGGAATCACTGGGTGTAAAGGGAGCGTAGACGGCTGTGCAAGCCTGAAGTGAAAGGCGGGGGCCCAACCCCTGGACTGCTTTGGGAACTGTACGGCTGGAGTGCAGGAGAGGTAAGTGGAATTCCTAG	False
TACGTAGGTGGCAAGCGTTATCCGGATTTATTGGGTGTAAAGGGCGTGTAGGCGGGAATGCAAGTCAGATGTGAAAACTATGGGCTCAACCCATAGCCTGCATTTGAAACTGTATTTCTTGAGTGCTGGAGAGGCAATCGGAATTCCGTG	False
TACGTAGGTGGCAAGCGTTGTCCGGATTTACTGGGTGTAAAGGGCGTGCAGCCGGGCTGACAAGTCAGATGTGAAATCCCGCGGCTCAACCGCGGAACTGCATTTGAAACTGTTAGTCTTGAGTACCGGAGAGGTCATCGGAATTCCTTG	True
TACGTAGGGAGCAAGCGTTGTCCGGATTTACTGGGTGTAAAGGGTGCGTAGGCGGCCCTGCAAGTCAGAAGTGAAATCCATGGGCTTAACCCGTGAACTGCTTTTGAAACTGTAGGGCTTGAGTGAAGTAGAGGCAGGCGGAATTCCCGG	True
TACGTAGGTGGCAAGCGTTGTCCGGATTTACTGGGTGTAAAGGGCGTGCAGCCGGGCCGACAAGTCAGATGTGAAATCCGCGGGCTTAACCCGCGAACTGCATTTGAAACTATTGGTCTTGAGTACCGGAGAGGTCATCGGAATTCCTTG	False
TACGTAGGTGGCAAGCGTTGTCCGGAATTACTGGGTGTAAAGGGAGCGTAGGCGGGAAAGCAAGTTGAATGTTTAAGGTACGGGCTCAACCTGTACAAGCGTTCAAAACTGTTTTTCTTGAGTGGAGTAGAGGTAAGCGGAATTCCTAGT	False
TACGTAGGGGGCAAGCGTTATCCGGATTTACTGGGTGTAAAGGGAGCGTAGACGGTTATGTAAGTCTGGAGTGAAAGCCCGGGGCCCAACCCCGGGACTGCTTTGGAAACTGTGTAACTGGAGTACAGGAGGGGCAGGCGGAATTCCTGG	False
TACGTAGGGGGCGAGCGTTATCCGGATTCATTGGGCGTAAAGCGCGCGTAGGCGGCCGCCTAAGCGGAACCTCTAATCCCGGGGCTCAACCTCGGGCCGGGTTCCGGACTGGGCGGCTCGAGTGCGGTAGAGGCAGTTGGAATTCCCGGT	False
TACGTAGGGGGCAAGCGTTATCCGGATTTACTGGGTGTAAAGGGAGCGTAGACGGCGATGCAAGTCTGAAGTGAAAGGCGGGGGCCCAACCCCCGGACTGCTTTGGAAACTGTATGGCTGGAGTGCAGGAGAGGTAAGTGGAATTCCTAG	True
TACGTAGGGGGCAAGCGTTATCCGGATTTACTGGGTGTAAAGGGAGCGTAGGCGGCAAGGTAAGCCAGAAGTGAAAGCCCGCGGCTCAACTGCGGGACTGCTTTTGGAACTATCTAGCTAGATTGCAGGAGAGGTAAGTGGAATTCCTAG	False
TACGTAGGTGGCAAGCGTTATCCGGATTTACTGGGTGTAAAGGGCGTGTAGGCGGGACTGCAAGTCAGATGTGAAACCCATGGGCTCAACCCATGGCCTGCATTTGAAACTGTAGTTCTTGAGTGATGGAGAGGCAGGCGGAATTCCGTG	True
TACGTAGGGAGCGAGCGTTGTCCGGATTTACTGGGTGTAAAGGGCGTGTAGGCGGAGCTGCAAGTCAGAAGTGAAATCTCCGGGCTCAACCCGGAAACTGCTTTTGAAACTGTAGCCCTTGAGTATCGGAGAGGCAGGCGGAATTCCTAG	False
TACGTAGGGGGCAAGCGTTATCCGGATTTACTGGGTGTAAAGGGAGCGTAGACGGCGGTGCAAGCCAGATGTGAAAGCCCGGGGCTCAACCCCGGGACTGCATTTGGAACTGTGCTGCTAGAGTGTCGGAGAGGCAGGCGGAATTCCTAG	True
TACGTAGGGGGCAAGCGTTATCCGGATTTACTGGGTGTAAAGGGAGCGTAGACGGTGATGCAAGTCAGAAGTGAAAGCCCGGGGCTCAACTCCGGGACTGCTTTTGAAACTGTGTAACTGGAGTGCAGGAGAGGTAAGCGGAATTCCTGG	False
TACGTAGGGGGCAAGCGTTATCCGGATTTACTGGGTGTAAAGGGAGCGTAGACGGCGATGCAAGCCAGATGTGAAAGCCCGGGGCTCAACCCCGGGACTGCATTTGGAACTGTATAGCTAGAGTGTCGGAGAGGCAGGCGGAATTCCTAG	True
TACGTAGGGGGCAAGCGTTATCCGGATTTACTGGGTGTAAAGGGAGCGTAGACGGATAAGCAAGTCTGATGTGAAAATCCGGGGCCCAACCCCGGAATTGCATTGGAAACTGCATATCTAGAGTGTCGGAGAGGCAAGTGGAATTCCTGG	False
TACGTAGGGGGCAAGCGTTATCCGGAATCACTGGGTGTAAAGGGAGCGTAGACGGCTGTGCAAGCCTGAAGTGAAAGGCGGGGGCCCAACCCCCGGACTGCTTTGGGAACTGTACGGCTGGAGTGCAGGAGAGGTAAGTGGAATTCCTAG	False
TACGTAGGTCCCGAGCGTTATCCGGATTTATTGGGCGTAAAGCGAGCGCAGGCGGTTGGATAAGTCTGAAGTTAAAGGCTGTGGCTCAACCATAGTATGCTTTGGAAACTGTTCAACTTGAGTGCAGAAGGGGAGAGTGGAATTCCATGT	False
TACGTAGGGGGCAAGCGTTATCCGGATTTACTGGGTGTAAAGGGAGCGTAGACGGTGAGACAAGTCTGAAGTGAAAGCCCGGGGCTCAACCCCGGGACTGCTTTGGAAACTGCCTGACTGGAGTGCTGGAGAGGCAAGCGGAATTCCTAG	False
TACGTATGGAGCAAGCGTTATCCGGATTTACTGGGTGTAAAGGGAGCGTAGGCGGTAAGGCAAGTCTGATGTGAAAGGCCAGGGCTCAACCCTGGGACTGCATTGGAAACTGTTTAACTGGAGTGTCGGAGAGGCAAGTGGAATTCCTAG	False
TACGTAGGGGGCGAGCGTTATCCGGATTCATTGGGCGTAAAGCGCGCGTAGGCGGCCGCCTAAGCGGAACCTCTAATCCCGGGGCTCAACCTCGGGCCGGGTTCCGGACTGGGCGGCTCGAGTGCGGTAGAGGCAGGCGGAATTCCCGGT	False
TACGTAGGTGGCAAGCGTTATCCGGATTTACTGGGTGTAAAGGGCGAGTAGGCGGGATTGCAAGTCAGATGTGAAAACTATGGGCTCAACCGATAGAGTGCATTTGAAACTGCAGTTCTTGAGTGATGGAGAGGCAGGCGGAATTCCCGG	True
TACGTAGGGGGCAAGCGTTATCCGGATTTACTGGGTGTAAAGGGAGCGCAGGCGGCAGGATGAGTCTGATGTGAAAACCCGCGGCTCAACCACGGGATTGCATTGGAAACTGTCCAGCTAGAGTGTCGGAGAGGTAAGCGGAATTCCTAG	False
TACGTAGGGGGCAAGCGTTATCCGGATTTACTGGGTGTAAAGGGAGCGTAGGTGGCGTGCCAAGTCAGGAGTGAAAACCCAGGGCCCAACCCTGGGACTGCTCTTGAAACTGGCAGGCTTGAGTGCTGGAGAGGTAAGCGGAATTCCTAG	True
TACGTAGGGGGCAAGCGTTATCCGGATTTACTGGGTGTAAAGGGAGCGTAGACGGCTGTGCAAGTCTGAAGTGAAAGCCCGTGGCTCAACCGCGGAACTGCTTTGGAAACTGTATAGCTTGAGTACTGGAGAGGCAGGCGGAATTCCTAG	False
TACGTAGGGGGCAAGCGTTATCCGGAATTATTGGGCGTAAAGAGTACGTAGGCGGTTCTTTAAGCGCAGGGTTTAAGGCGATAGCTTAACTATCGTTCGCCCTGTGAACTGGGGGACTTGAGTATCGGAGAGGAAAGCGGAATTCCTAGT	True
TACGTAGGTGGCGAGCGTTATCCGGATTTATTGGGCGTAAAGCGTGCGCAGGCGGCTTATTAAGTCTAAGATTAAAGCCCGGAGCTTAACTCCGGTTCGTCTTAGAAACTGGTAGGCTTGAGTATGGTAGAGGCAAACGGAATTCCTAGT	False
TACGTAGGGGGCAAGCGTTATCCGGATTTACTGGGTGTAAAGGGAGCGTAGACGGACTTGCAAGTCTGATGTGAAAATCCGGGGCCCAACCCCGGAACTGCATTGGAAACTGTATATCTAGAGTGTCGGAGAGGCAAGTGGAATTCCTGG	False
TACGTAGGGGGCGAGCGTTATCCGGATTCATTGGGCGTAAAGCGCGCGTAGGCGGGTGCCTAAGCGGGACCTCTAACCTCGGGGCTCAACCCCGAGCCGGGTCCCGAACTGGGCGCCTCGAGTGCGGTAGGGGAGATCGGAATTCCCGGT	True
TACGTAGGTGGCAAGCGTTATCCGGAATTATTGGGCGTAAAGAGCGCGCAGGTGGTTAATTAAGTCTGATGTGAAAGCCCACGGCTTAACCGTGGAGGGTCATTGGAAACTGGTTGACTTGAGTGCAGAAGAGGGAAGTGGAATTCCATG	True
TACGTAGGGGGCAAGCGTTATCCGGATTTACTGGGTGTAAAGGGAGCGTAGACGGCGAAGAAAGTCTGAAGTGAAAGCCCGCGGCTCAACCGCGGAACTGCTTTGGAAACTTTTTTGCTGGAGTACCGGAGAGGTAAGCGGAATTCCTAG	True
AATTGAGAGGCTCAACCTCTTCCCGCCGTTGAAACTGGTGGTCTTGAGTGGATGAGAAGTACGCGGAATGCGTGGTGTAGCGGTGAAATGCATAGATATCACGCAGAACTCCGATTGCGAAGGCAGCGTACCGGCATCCAACTGACGCTG	False
TACGTAGGGGGCAAGCGTTATCCGGAATCACTGGGTGTAAAGGGAGCGTAGACGGCTGAGCAAGCCTGAAGTGAAAGGCGGGGGCCCAACCCCCGGACTGCTTTGGGAACTGTACGGCTGGAGTGCAGGAGAGGTAAGTGGAATTCCTAG	False
TACGTAGGTGGCAAGCGTTGTCCGGATTTACTGGGTGTAAAGGGCGTGCAGCCGGAGAGACAAGTCAGATGTGAAATCCACGGGCTCAACCCGTGAACTGCATTTGAAACTGTTTTTCTTGAGTACTGGAGAGGCAGACGGAATTCCTAG	False
TACGTAGGGGGCAAGCGTTATCCGGATTCATTGGGCGTAAAGCGCGCGCAGGCGGGCCGCTAAGCGGGACCTCTAATCTTGGGGCTCAACCTCAAGCCGGGTCCCGAACTGGCAGCCTCGAGTGCGGTAGGGGTAAGCGGAATTCCCGGT	False
AATTGAGAGGCTCAACCTCTTCCCGCCGTTGAAACTGATTGTCTTGAGTGGGCGAGAAGTATGCGGAATGCGTGGTGTAGCGGTGAAATGCATAGATATCACGCAGAACTCCGATTGCGAAGGCAGCATACCGGCGCCCAACTGACGCTG	False
TACGTAGGGGGCAAGCGTTATCCGGATTTACTGGGTGTAAAGGGAGCGTAGACGGCTGTACAAGTCTGAAGTGAAAGCCCGTGGCTCAACCGCGGAACTGCTTTGGAAACTGTAAAGCTGGAGTACTGGAGAGGCAGGCGGAATTCCTAG	False
TACGTAGGGGGCAAGCGTTATCCGGATTCACTGGGCGTAAAGGGAGCGCAGGCGGCACGGCAAGTCTGGTGTGAAAACCCGGGGCTCAACCCCGGGACTGCATTGGAAACTGCCGGGCTGGAGTGTCGGAGGGGTAAGCGGAATTCCTAG	False
TACGTAGGGGGCGAGCGTTATCCGGATTTACTGGGTGTAAAGGGAGCGTAGACGGTTCTGCAAGTCTGAAGTGAAAGCCCGTGGCTTAACCGCGGAACGGCTTTGGAAACTGTGGAACTGGAGTGCTGGAGAGGCAAGCGGAATTCCTAG	False
TACGTAGGGGGCAAGCGTTATCCGGATTTACTGGGTGTAAAGGGAGCGTAGACGGCAGAGCAAGTCCGGAGTGAAAGCCCGGGGCCCAACCCCGGGACTGCTCTGGAAACTGTTAAGCTGGAGTACGGGAGGGGCAGGCGGAATTCCTGG	False
TACGTAGGGAGCAAGCGTTGTCCGGATTTACTGGGTGTAAAGGGTGCGTAGGCGGCTTTGCAAGTCAGAAGTGAAATCCATGGGCTTAACCCATGAACTGCTTTTGAAACTGCAGAGCTTGAGTGGAGTAGAGGTAGGCGGAATTCCCGG	False
TACGTAGGGGGCAAGCGTTATCCGGATTTACTGGGTGTAAAGGGAGCGCAGACGGCTGTGCAAGTCTGGAGTGAAAGGCGGGGGCCCAACCCCCGGACTGCTCTGGAAACTGTAAAGCTGGAGTGCAGGAGAGGTAAGCGGAATTCCTAG	False
TACGTAGGGGGCAAGCGTTATCCGGATTTACTGGGTGTAAAGGGAGCGTAGACGGCGAAGCAAGTCTGATGTGAAAGGCAGGGGCTCAACCCCTGGACTGCATTGGAAACTGTTTTGCTAGAGTGCCGGAGAGGTAAGCGGAATTCCTAG	False
TACGTAGGGGGCAAGCGTTATCCGGATTTACTGGGTGTAAAGGGAGCGTAGGTGGCATGGTAAGCCAGAAGTGAAAACCCAGGGCTCAACTCTGTGGATTGCTTTTGGAACTATCAAGCTAGAGTGCTGGAGGGGTAAGCGGAATTCCTA	False
TACGGAGGATCCGAGCGTTATCCGGATTTATTGGGTTTAAAGGGAGCGTAGATGGATGTTTAAGTCAGTTGTGAAAGTTTGCGGCTCAACCGTAAAATTGCAGTTGATACTGGATATCTTGAGTGCAGTTGAGGCAGGCGGAATTCGTGG	False
TACGTAGGGGGCAAGCGTTATCCGGATTTACTGGGTGTAAAGGGAGCGTAGACGGTATGGCAAGTCTGAAGTGAAAGCCCCGGGCTCAACCTGGGAACTGCTTTGGAAACTGTTAAACTAGAGTGCTGGAGAGGCAGGCGGAATTCCTAG	False
TACGTAGGGGGCAAGCGTTATCCGGATTTACTGGGTGTAAAGGGAGCGTAGACGGAATAGCAAGTCTGATGTGAAAACCCGGGGCTCAACTCCGGGAGTGCATTGGAAACTGTTGATCTAGAGTGTCGGAGAGGCAAGCGGAATTCCTAG	True
TACGTAGGGGGCAAGCGTTATCCGGATTTACTGGGTGTAAAGGGAGCGTAGACGGTTAATCAAGTCAGAAGTGAAAACCCAGGGCTCAACCTTGGGACTGCTTTTGAAACTGAGTAGCTAGAGTGCAGGAGAGGTAAGCGGAATTCCTAG	True
TACGTAGGGGGCAAGCGTTATCCGGATTTACTGGGTGTAAAGGGAGCGTAGGCGGCAGTGCAAGTCAGAAGTGAAAGCCCAAGGCTCAACCATGGGACTGCTTTTGAAACTGTACAGCTAGATTGCAGGAGAGGTAAGTGGAATTCCTAG	False
TACGTAGGTGGCGAGCGTTATCCGGATTTACTGGGTGTAAAGGGCGTGTAGGCGGGAGAGCAAGTCAGATGTGAAAACTACAGGCTTAACCTGTAGCCTGCATTTGAAACTGTTTTTCTTGAGTGATGGAGAGGCAGGCGGAATTCCTAG	False
TACGTAGGTGGCAAGCGTTGTCCGGATTTACTGGGTGTAAAGGGCGTGCAGCCGGGAAGACAAGTCAGATGTGAAATCCCGCGGCTCAACCGCGGAACTGCATTTGAAACTGTTTTTCTTGAGTATCGGAGAGGTAATCGGAATTCCTAG	False
TACGTATGGAGCAAGCGTTATCCGGAATTACTGGGTGTAAAGGGAGCGTAGACGGATGTGCAAGTCTGATGTGAAAGGCGGGGGCTCAACCCCTGGACTGCATTGGAAACTGTAAATCTTGAGTGCCGGAGAGGTAAGCGGAATTCCTAG	True
TACGTAGGGGGCAAGCGTTATCCGGATTTACTGGGTGTAAAGGGAGCGTAGACGGCTAATCAAGTCAGAAGTGAAAACCCAGGGCTCAACTTTGGGACTGCTTTTGAAACTGAGTAGCTAGAGTGCAGGAGAGGTAAGCGGAATTCCTAG	False
TACGTAGGGGGCAAGCGTTATCCGGATTTACTGGGTGTAAAGGGAGCGTAGACGGCTAATCAAGTCAGAAGTGAAAACCCAGGGCTCAACCTTGGGACTGCTTTTGAAACTGAGTAGCTAGAGTGCAGGAGAGGTAAGCGGAATTCCTAG	False
TACGTAGGGGGCAAGCGTTATCCGGAATTACTGGGTGTAAAGGGAGCGTAGGCGGCATGGTAAGCCAGATGTGAAAGCCCGCGGCTTAACCGCGCGGATTGCATTTGGAACTATCAAGCTAGAGTACAGGAGAGGAAAGCGGAATTCCTA	False
TACGTAGGGGGCAAGCGTTATCCGGATTTACTGGGTGTAAAGGGAGCGTAGACGGCTGTGCAAGTCTGAAGTGAAAGCCCAGGGCTCAACCCTGGGACTGCTTTGGAAACTGTGGAGCTAGAGTGCTGGAGAGGTAAGTGGAATTCCTAG	True
TACGTAGGGGGCGAGCGTTATCCGGATTTACTGGGTGTAAAGGGAGCGTAGACGGCCATGCAAGCTCGGTGTGAAAGGTGCGGGCACAACCCGCAGACTGCACTGAGAACTGTATGGCTGGAGTGCCGGAGGGGCAGGCGGAATTCCTGG	False
TACGTAGGGGGCAAGCGTTATCCGGATTTACTGGGTGTAAAGGGAGCGTAGACGGTTGTATAAGTCTGGAGTGAAAGCCCGGGGCCCAACCCCGGGACTGCTTTGGAAACTGTGTAACTTGAGTACAGGAGGGGCAGGCGGAATTCCTGG	False
TACGTAGGGGGCAAGCGTTATCCGGATTTACTGGGTGTAAAGGGAGCGTAGACGGAGGAGCAAGTCTGAAGTGAAAGCCCGCGGCTCAACTGCGGGACTGCTTTGGAAACTGTTCATCTAGAGTGTCGGAGAGGTAAGTGGAATTCCTAG	False
TACGTATGGAGCAAGCGTTATCCGGAATTACTGGGTGTAAAGGGAGCGTAGACGGATCTGCAAGTCTGATGTGAAAGGCGGGGGCTCAACTCCTGGACTGCATTGGAAACTGTAGATCTTGAGTGCCGGAGAGGTAAGCGGAATTCCTAG	False
TACGTAGGGGGCAAGCGTTATCCGGATTTACTGGGTGTAAAGGGGGCGCAGACGGCCATGGCAAGCCCGGTGTGAAAGGCAGGGGCATAACCCCTGGACTGCACTGGGAACTGTCAGGCTGGAGTGCCGGAGGGGTAAGCGGAATTCCTG	False
TACGTAGGTGGCAACCTAAGCGCAGGGTTTAAGGCAATGGCTCAACCATTGTTCGCCCTGCGAACTGGGATGCTTGAGTGCAGGAGAGGAAAGCGGAATTCCTAGTGTAGCGGTGAAATGCGTAGATATTAGGAGGAACACCAGTGGCGA	False
TACGGAGGGTGCAAGCGTTACTCGGAATCACTGGGCGTAAAGAGCGTGTAGGCGGGTATATAAGTCAGAAGTGAAATCCTATAGCTTAACTATAGAACTGCTTTTGAAACTGTATACCTAGAATGTGGGAGAGGTAGATGGAATTTCTGG	False
TACGTAGGGGGCAAGCGTTATCCGGATTTACTGGGTGTAAAGGGAGCGTAGACGGCCATGCAAGTCTGATGTGAAAACCCGGGGCTCAACCCCGGGACTGCATTGGAAACTGTGCGGCTGGAGTGTCGGAGAGGCAAGTGGAATTCCTAG	False
TACGTATGGAGCAAGCGTTATCCGGATTTACTGGGTGTAAAGGGAGCGCAGGCGGCCTTGCAAGTCTGATGTGAAATACCGGGGCTCAACCCCGGAGCTGCATTGGAAACTGTGAGGCTGGAGTGTCGGAGAGGCAGGCGGAATTCCTAG	True
TACGTAGGTGGCAAGCGTTATCCGGATTTACTGGGTGTAAAGGGCGTGTAGGCGGGGACGCAAGTCAGATGTGAAAACCACGGGCTCAACCTGTGGCCTGCATTTGAAACTGTGTTTCTTGAGTACTGGAGAGGCAGACGGAATTCCTAG	False
TACGTAGGGGGCTAGCGTTATCCGGAATTACTGGGCGTAAAGGGTGCGTAGGTGGTTTCTTAAGTCAGAGGTGAAAGGCTACGGCTCAACCGTAGTAAGCCTTTGAAACTGGGGAACTTGAGTGCAGGAGAGGAGAGTGGAATTCCTAGT	True
TACGTAGGGGGCAAGCGTTATCCGGATTCACTGGGTGTAAAGGGAGCGTAGACGGCCATGCAAGCCTGGAGTGAAAGCCCGGGGCCCAACCCCGGGACTGCTCTGGGAACTGTGCGGCTGGAGTGCGGGAGGGGCAGGCGGAATTCCTGG	False
AACGTAGGGTGCAAGCGTTGTCCGGAATTACTGGGTGTAAAGGGAGCGCAGGCGGATTGGCAAGTTGGGAGTGAAATCTATGGGCTCAACCCATAAATTGCTTTCAAAACTGTCAGTCTTGAGTGGTGTAGAGGTAGGCGGAATTCCCGG	True
TACGTAGGTGGCGAGCGTTGTCCGGATTTACTGGGCGTAAAGGGAGCGTAGGCGGACTTTTAAGTGAGATGTGAAATACTCGGGCTCAACTTGAGTGCTGCATTTCAAACTGGAAGTCTAGAGTGCAGGAGAGGAGAATGGAATTCCTAG	True
TACGTAGGGGGCTAGCGTTATCCGGAATTACTGGGCGTAAAGGGTGCGTAGGTGGTTTCTTAAGTCAGAGGTGAAAGGCTACGGCTCAACCGTAGTAAGCCTTTGAAACTGGGAAACTTGAGTGCAGGAGAGGAGAGTGGAATTCCTAGT	True
TACGTATGGGGCAAGCGTTATCCGGATTTACTGGGTGTAAAGGGAGCGCAGGCGGCCTGGCAAGCCTGATGTGAAATACCGGGGCCCAACCCCGGGGCTGCATTGGGAACTGCCAGGCTGGAGTGCCGGAGAGGCAGGCGGAATTCCTAG	True
TACGTATGGTGCAAGCGTTATCCGGATTTACTGGGTGTAAAGGGAGCGCAGGCGGCGCGTTAAGCCTGGTGTGAAAGCCCGCGGCCCAACCGCGGGACTGCATTGGGAACTGGCGCGCTGGAGTGCCGGAGGGGTAGGCGGAATTCCTAG	True
TACGTAGGGGGCAAGCGTTATCCGGATTTACTGGGTGTAAAGGGAGCGTAGACGGCCAGACAAGTCAGAAGTGAAAGCCCAGGGCTCAACCCTGGGACTGCTTTTGAAACTGCCGGGCTGGAGTGCAGGAGAGGTAAGCGGAATTCCTAG	False
TACGTAGGTGGCGAGCGTTGTCCGGATTTACTGGGCGTAAAGGGAGCGTAGGCGGACTTTTAAGTGAGATGTGAAATACTCGGGCTCAACTTGAGTGCTGCATTTCAAACTGGAAGTCTAGAGTGCAGGAGAGGAGAATGGAATTCTTAG	True
TACGTAGGGGGCTAGCGTTATTCGGAATTACTGGGCGTAAAGGGTGCGTAGGTGGTTTCTTAAGTCAGAGGTGAAAGGCTACGGCTCAACCGTAGTAAGCCTTTGAAACTGGGAAACTTGAGTGCAGGAGAGGAGAGTGGAATTCCTAGT	False
TACGTATGGTGCAAGCGTTATCCGGATTTACTGGGTGTAAAGGGAGCGTAGACGGAGAGGCAAGTCTGATGTGAAAACCCGGGGCTCAACCCCGGGACTGCATTGGAAACTGTTTTTCTAGAGTGTCGGAGAGGCAAGTGGAATTCCTAG	True
TACGTAGGTGGCAAGCGTTATCCGGATTTATTGGGTGTAAAGGGCGTGTAGGCGGGAGCGCAAGTCAGATGTGAAAACTCAGGGCTCAACCCTGAGCCTGCATTTGAAACTGTGTTTCTTGAGTGCTGGAGAGGCAATCGGAATTCCGTG	True
TACGGAGGGTGCAAGCGTTAATCGGAATTACTGGGCGTAAAGCGCACGCAGGCGGTTTGTTAAGTCAGATGTGAAATCCCCGGGCTCAACCTGGGAACTGCATCTGATACTGGCAAGCTTGAGTCTCGTAGAGGGGGGTAGAATTCCAGG	False
TACGTAGGGGGCAAGCGTTATCCGGATTTACTGGGTGTAAAGGGAGCGTAGGCGGCCATGCAAGTCAGAAGTGAAAACCCGGGGCTCAACCCTGGGAGTGCTTTTGAAACTGTGCGGCTAGAGTGTCGGAGGGGTAAGTGGAATTCCTAG	False
TACGTAGGGAGCGAGCGTTGTCCGGAATTACTGGGCGTAAAGGGCGCGTAGGCGGGAACTTAAGTTAGATGTGAAAACTCCGGGCTTAACCTGGAGACTGCATTTAAAACTGGGTTTCTTGAGGGCAGGAGAGGAAAGTGGAATTCCTAG	False
TACGTAGGGGGCAAGCGTTATCCGGATTTACTGGGTGTAAAGGGAGCGTAGGCGGCCACGCAAGTCAGAAGTGAAAACCCGGGGCTCAACCCTGGGAGTGCTTTTGAAACTGTGCGGCTAGAGTGTCGGAGGGGTAAGTGGAATTCCTAG	True
TACGTAGGGGGCAAGCGTTATCCGGATTTACTGGGTGTAAAGGGAGCGTAGACGGCGATGCAAGCCAGATGTGAAAGCCCGGGGCTCAACCCCGGGACTGCATTTGGAACTGTGTGGCTGGAGTGTCGGAGAGGCAAGTGGAATTCCTAG	True
TACGTAGGTGGCGAGCGTTGTCCGGAATTACTGGGTGTAAAGGGAGCGTAGGCGGGAGAGCAAGTCGACTGTGAAATCTATGGGCTTAACCCATAGCTGCGATCGAAACTGTTCATCTTGAGTGAAGTAGAGGCAGGCGGAATTCCTAGT	False
TACGTAGGGGGCAAGCGTTATCCGGATTTACTGGGTGTAAAGGGAGCGTAGACGGCTGCGCAAGTCAGAAGTGAAAGCCCGGGGCTCAACCGCGGGACTGCTTTTGAAACTGTGTAGCTAGAGTGCAGGAGAGGTAAGTGGAATTCCTAG	False
TACGTAGGGGGCAAGCGTTATCCGGATTTACTGGGTGTAAAGGGAGCGTAGACGGCAGCGCAAGCCTGGAGTGAAAGGATGGGGCCCAACCCCATGACTGCTCTGGGAACTGTGCGGCTAGAGTGCCGGAGGGGTAAGCGGAATTCCTAG	False
TACGTAGGGAGCAAGCGTTATCCGGATTTATTGGGTGTAAAGGGTGCGTAGACGGGAAGGCAAGTTGGTTGTGAAATCCCTCGGCTTAACTGAGGAACTGCAACCAAAACTATCTTTCTTGAGTGCTGGAGAGGAAAGTGGAATTCCTAG	True
TACGTAGGGGGCAAGCGTTATCCGGATTTACTGGGTGTAAAGGGAGCGTAGACGGCTGTGCAAGTCAGAAGTGAAAGCCCGGGGCTCAACCGCGGGACTGCTTTTGAAACTGTGTAGCTGGAGTGCAGGAGAGGTAAGTGGAATTCCTAG	False
TACGTAGGTGGCGAGCGTTGTCCGGATTTACTGGGCGTAAAGGGAGCGTAGGCGGACTTTTAAGTGAGATGTGAAATACTCGGGCTCAACTTGAGTGCTGCATTTCAAACTGGAAGTCTGGAGTGCAGGAGAGGAGAATGGAATTCCTAG	True
TACGGAGGATGCGAGCGTTATCCGGATTTATTGGGTTTAAAGGGTGCGTAGGCGGACTGTCAAGTCAGCGGTAAAATTGAGAGGCTCAACCTCTTCCCGCCGTTGAAACTGTGAGGCTTGAGTGAAGTAGAGGTAGGCGGAATTCCCGGT	False
TACGTAGGGGGCAAGCGTTATCCGGATTTACTGGGTGTAAAGGGAGCGTAGACGGCCAGGCAAGTCTGGAGTGAAAGCCCGGGGCTCAACCCCGGGACTGCTTTGGAAACTGTAGGGCTGGAGTGCAGGAGGGGTAAGCGGAATTCCTAG	False
TACGTAGGGAGCGAGCGTTGTCCGGAATTACTGGGTGTAAAGGGAGCGTAGGCGGGGATGCAAGTTGGGTGTTAAATCTACCGGCTCAACTGGTAGTCGCACTCAAAACTGCAGCTCTTGAGTGAAGTAGAGGCAGGCGGAATTCCTAGT	False
TACGTAGGGAGCAAGCGTTGTCCGGAATTACTGGGTGTAAAGGGAGCGTAGGCGGGAGGATAAGTTGAATGTGAAATCTATGGGCTCAACCCATAGCTGCGTTCAAAACTGTTCTTCTTGAGTGAAGTAGAGGCAGGCGGAATTCCTAGT	False
TACGTAGGGGGCAAGCGTTATCCGGAATTATTGGGCGTAAAGAGTGCGTAGGTGGTTACTTAAGCGCGGGGTTTAAGGCAATGGCTCAACCATTGTTCGCCCTGCGAACTGGGTTACTTGAGTGCAGGAGAGGAAAGCGGAATTCCTAGT	False
TACATAGGGAGCAAGCGTTATCCGGAATTATTGGGTGTAAAGGGTGCGTAGACGGAGGAACAAGTTAGTTGTGAAATCCCTCGGCTTAACTGAGGAACTGCAACTAAAACTATTCCCCTTGAGTGTCGGAGAGGAAAGTGGAATTCCTAG	False
TACGTAGGGAGCAAGCGTTATCCGGATTTATTGGGTGTAAAGGGTGCGTAGACGGGCTAACAAGTTAGTTGTGAAATCCCTCGGCTTAACTGAGGAACTGCAACTAAAACTATTAGTCTCTGAGTGCGGGAGAGGAAAGTGGAATTCCTA	False
TACGTATGGTGCAAGCGTTATCCGGATTTACTGGGTGTAAAGGGAGCGCAGGCGGTACGGCAAGTCTGATGTGAAAGCCCGGGGCTCAACCCCGGTACTGCATTGGAAACTGTCGGACTAGAGTGTCGGAGGGGTAAGTGGAATTCCTAG	False
TACGTATGGAGCAAGCGTTATCCGGATTTACTGGGCGTAAAGGGAGCGTAGGCGGCCTGCCAAGTCTGATGTGAAATACCGGGGCTCAACCCCGGGGCTGCATTGGAAACTGGCAGGCTGGAGTGCCGGAGAGGCAGGCGGAATTCCTAG	True
TACGTAGGGGGCAAGCGTTATCCGGATTTACTGGGTGTAAAGGGAGCGTAGACGGCGATGCAAGTCTGAAGTGAAAGGCGGGGGCCCAACCCCCGGACTGCTTTGGAAACTGTATAGCTGGAGTGCAGGAGAGGTAAGTGGAATTCCTAG	True
TACGTAGGGGGCAAGCGTTATCCGGATTTACTGGGTGTAAAGGGAGCGTAGACGGCTGTGCAAGCCAGATGTGAAAGCCCGGGGCTCAACCCCGGGACTGCATTTGGAACTGTGTGGCTGGAGTGTCGGAGAGGCAGGCGGAATTCCTAG	True
TACGTAGGGAGCGAGCGTTATCCGGATTTATTGGGTGTAAAGGGTGCGTAGATGGATAAACAAGTTGGTTGTGAAATCCCTCGGCTTAACTGAGGAATTGCAACCAAAACTGTAGATCTTGAGTACTGGAGGGGAAAGCGGAATTCCTAG	False
TACGTAGGGAGCGAGCGTTATCCGGAATTATTGGGTGTAAAGGGTGCGTAGACGGGAAAGCAAGTTAGTTGTGAAATCCCTCGGCTTAACTGAGGAACTGCAACTAAAACTACTTTTCTTGAGTGCAGGAGAGGTAAGTGGAATTCCTAG	True
TACGTAGGGGGCAAGCGTTATCCGGATTTACTGGGTGTAAAGGGAGCGTAGACGGCATGGCAAGTCAGATGTGAAAGCCCGGGGCTCAACCCCGGGACTGCATTTGAAACTGTCAGGCTGGAGTGCAGGAGAGGTAAGTGGAATTCCTAG	True
TACGTAGGGGGCAAGCGTTATCCGGATTTACTGGGTGTAAAGGGAGCGTAGACGGCAGGGCAAGTCTGATGTGAAAGGTCGGGGCCCAACCCCGGGACTGCATTGGAAACTGTCCGGCTGGAGTACAGGAGAGGTAAGTGGAATTCCTAG	False
TACGTAGGGGGCAAGCGTTATCCGGATTTACTGGGTGTAAAGGGAGCGTAGGCGGTTCAGCAAGTCAGAAGTGAAAGCCCGGGGCTCAACTCCGGGACTGCTTTTGAAACTGTTGAACTAGATTGCAGGAGAGGTAAGTGGAATTCCTAG	False
TACGTATGGGGCAAGCGTTATCCGGATTTACTGGGTGTAAAGGGAGCGTAGGCGGCCTGGCAAGCCTGATGTGAAATACCGGGGCCCAACCCCGGGGCTGCATTGGGAACTGCCAGGCTGGAGTGCCGGAGAGGCAGGCGGAATTCCTAG	True
TACGTAGGGGGCAAGCGTTATCCGGATTTACTGGGTGTAAAGGGAGCGTAGACGGTTATGCAAGTCTGAAGTGAAAGCCCAAGGCTCAACCATGGGACTGCTTTGGAAACTGTAAAACTGGAGTGCAGGAGAGGTAAGCGGAATTCCTAG	False
TACGTAGGTGGCAAGCGTTATCCGGAATTATTGGGCGTAAAGCGCGCGTAGGCGGTTTTTTAAGTCTGATGTGAAAGCCCACGGCTCAACCGTGGAGGGTCATTGGAAACTGGAAAACTTGAGTGCAGAAGAGGAAAGTGGAATTCCATG	False
TACGTAGGGGGCGAGCGTTATCCGGATTCACTGGGCGTAAAGGGAGCGCAGGCGGCACGGCAAGTCCGGTGTGAAAGCCCGGGGCCCAACCCCGGGACTGCACTGGAAACTGCCGGGCTGGAGTGTCGGAGGGGCAGGCGGAATTCCTAG	True
TACGTAGGTCCCGAGCGTTGTCCGGATTTATTGGGCGTAAAGCGAGCGCAGGCGGTTTGATAAGTCTGAAGTTAAAGGCTGTGGCTCAACCATAGTTCGCTTTGGAAACTGTCAAACTTGAGTGCAGAAGGGGAGAGTGGAATTCCATGT	False
TACGTAGGGGGCAAGCGTTATCCGGATTTACTGGGTGTAAAGGGAGCGTAGACGGCCAGACAAGTCAGAAGTGAAAACCCGCGGCTCAACTGCGGGAGTGCTTTTGAAACTGTTTGGCTGGAGTGCAGGAGAGGTAAGTGGAATTCCTAG	False
TACGTAGGGGGCAAGCGTTATCCGGATTTACTGGGTGTAAAGGGAGCGTAGACGGCTGTGCAAGTCTGGAGTGAAAGGCATGGGCTCAACCTGTGGACTGCTTTGGAAACTGTGCGGCTTGAGTGTCGGAGAGGCAAGTGGAATTCCTAG	False
TACGTAGGGGGCGAGCGTTATCCGGAATTACTGGGTGTAAAGGGAGCGTAGACGGCGAGGTAAGCCTGAAGTGGAAGCCCGCGGCCCAACCGCGGAACTGCTTTGGGAACTGTTTTGCTGGAGTATGGGAGGGGTAAGCGGAATTCCTGG	False
TACGTAGGTGGCAAGCGTTATCCGGAATTATTGGGCGTAAAGCGCGCGTAGGCGGTTTCTTAAGTCTGATGTGAAAGCCCACGGCTCAACCGTGGAGGGTCATTGGAAACTGGGAAACTTGAGTGCAGAAGAGGAAAGTGGAATTCCATG	False
TACGGAGGATGCGAGCGTTATCCGGATTTATTGGGTTTAAAGGGTGCGTAGGCGGACTGTCAAGTCAGCGGTAAAATTGAGAGGCTCAACCTCTTCCCGCCGTTGAAACTGTTTTTCTTGAGTGCTGGAGAGGCAATCGGAATTCCGTGT	False
TACGTAGGGGGCAAGCGTTATCCGGATTTACTGGGTGTAAAGGGAGCGTAGACGGCGGCGCAAGCCAGATGTGAAAGCCCGGGGCTCAACCCCGGGACTGCATTTGGAACTGTGCTGCTAGAGTGTCGGAGAGGCAGGCGGAATTCCTAG	False
TACGTAGGGGGCAAGCGTTATCCGGATTTACTGGGTGTAAAGGGAGCGTAGGCGGTGCGCCAAGCTGGGTGTGAAAGGCCGGGGCTCAACCCCGGGACTGCACTCGGAACTGGCGTGCTAGAGTGTTGGAGAGGTAAGCGGAATTCCTAG	False
TACGTAGGTGGCAAGCGTTGTCCGGATTTACTGGGTGTAAAGGGCGTGTAGGCGGAGCTGCAAGTCAGATGTGAAATCCCGGGGCTCAACCCCGGAACTGCATTTGAAACTGTAGCCCTTGAGTATCGGAGAGGCAGGCGGAATTCCTAG	False
TACGTAGGTGGCGAGCGTTGTCCGGAATTACTGGGTGTAAAGGGCGTGTAGGCGGGTAGATAAGTCAGATGTGAAATACCGGGGCTCAACCCCGGGGCTGCATTTGAAACTGTCAATCTTGAGTGCCGGAGAGGAAAGCGGAATTCCTAG	True
TACGTAGGGGGCAAGCGTTATCCGGATTTACTGGGTGTAAAGGGTGCGTAGGTGGCAGGGCAAGTCAGATGTGAAAGCCCGGGGCTCAACCCCGGTACTGCATTTGAAACTGTCCAGCTGGAGTGCAGGAGAGGTAAGCGGAATTCCTAG	False
TACGTAGGGTGCAAGCGTTAATCGGAATTACTGGGCGTAAAGCGTGCGCAGGCGGTTATGTAAGACAGGCGTGAAATCCCCGGGCTTAACCTGGGAATTGCGCTTGTGACTGCATAGCTAGAGTATGTCAGAGGGGGGTAGAATTCCACG	False
TACGTAGGTGGCGAGCGTTATCCGGAATGATTGGGCGTAAAGGGTGCGCAGGCGGTCCTGCAAGTCTGGAGTGAAACGTATGAGCTCAACTCATGCATGGCTCTGGAAACTGGAGGACTGGAGAGCAGGAGAGGGCGGTGGAACTCCATG	True
TACGGAGGGTGCAAGCGTTAATCGGAATTACTGGGCGTAAAGCGTGCGTAGGCGGCTCGCTAAGTCAGATGTGAAAGCCCCGGGCTCAACCTGGGAACGGCATTTGAAACTGGCAAGCTAGAGTTTAGGAGAGGAGAGTGGAATTTCAGG	False
TACGTAGGGTGCGAGCGTTAATCGGAATTACTGGGCGTAAAGCGTGCGCAGGCGGTTATATAAGACAGATGTGAAATCCCCGGGCTCAACCTGGGAACTGCATTAGTGACTGTATAGCTAGAGTGCGGCAGAGGGGGATGGAATTCCGCG	False
TACAGAGGGTGCAAGCGTTAATCGGAATTACTGGGCGTAAAGCGCGCGTAGGCGGTTGTGTAAGTTGGAGGTGAAATCCCCGGGCTTAACCTGGGCACTGCCTTCAAAACTGCACGGCTAGAGTATGGGAGAGGAAGGTAGAATTCCAGG	False
TACGTAGGGTGCGAGCGTTAATCGGAATTACTGGGCGTAAAGCGTGCGCAGGCGGTTATATAAGACAGATGTGAAATCCCCGGGCTCAACCTGGGAACTGCATTTGTGACTGTATAGCTAGAGTACGGCAGAGGGGGATGGAATTCCGCG	False
TACGGAGGGTGCAAGCGTTAATCGGAATTACTGGGCGTAAAGCGCGCGTAGGCGGCTTGTTAAGTCGGATGTGAAATCCCCGAGCTCAACTTGGGAACTGCATTCGATACTGGCTCGCTAGAGTGTGGTAGAGGGAAGTGGAATTCCAGG	False
TACGAAGGGGGCTAGCGTTGTTCGGAATTACTGGGCGTAAAGCGCACGTAGGCGGATATTTAAGTCAGGGGTGAAATCCCGCAGCTCAACTGCGGAACTGCCTTTGATACTGGGTATCTCGAGTATGGAAGAGGTGAGTGGAATTCCGAG	False
TACGTATGGAGCGAGCGTTGTCCGGAATTATTGGGCGTAAAGGGTACGCAGGCGGTTTAATAAGTCGAATGTTAAAGATCGGGGCTCAACCCCGTAAAGCATTGGAAACTGATAAACTTGAGTAGTGGAGAGGAAAGTGGAATTCCTAGT	False
TACGAAGGGGGCTAGCGTTGCTCGGAATTACTGGGCGTAAAGGGCGCGTAGGCGGACAGTTTAGTCAGAGGTGAAAGCCCAGGGCTCAACCTTGGAATAGCCTTTGATACTGACTGTCTTGAGTACGGGAGAGGTGTGTGGAACTCCGAG	False
TACGTAGGGTCCAAGCGTTAATCGGAATTACTGGGCGTAAAGCGTGCGCAGGCGGTTGTGCAAGACCGATGTGAAATCCCCGAGCTTAACTTGGGAATTGCATTGGTGACTGCACGGCTAGAGTGTGTCAGAGGGGGGTAGAATTCCACG	False
TACGGGGGGTGCAAGCGTTGTTCGGAATCATTGGGCGTAAAGAGCGTGTAGGCGGCTGGATAAGTCAGATGTGAAAGCCCTGGGCTTAACCCAGGAAGTGCATTTGAAACTATTCAGCTGGAGTAAGGGAGAGGAAAGTGGAATTCCTGG	False
TACGGAGGGAGCTAGCGTTGTTCGGAATTACTGGGCGTAAAGCGCACGTAGGCGGCGATTTAAGTCAGAGGTGAAAGCCCGGGGCTCAACCCCGGAACTGCCTTTGAGACTGGATTGCTAGAATCTTGGAGAGGCGAGTGGAATTCCGAG	False
TACGTAGGGGGCAAGCGTTATCCGGAATTACTGGGCGTAAAGGGTGCGTAGGCGGTTTATCAAGTCAGGGGTGAAAGGCTACGGCTCAACCGTAGTGAGCCTCTGAAACTGGTGAACTTGAGTGTAGGAGAGGAAAGTGGAATTCCCAGT	False
TACGTAGGGTGCGAGCGTTAATCGGAATTACTGGGCGTAAAGCGTGCGCAGGCGGTTTTGTAAGACAGAGGTGAAATCCCCGGGCTCAACCTGGGAACTGCCTTTGTGACTGCAAGGCTAGAGTACGGCAGAGGGGGATGGAATTCCGCG	False
GACGTAGGGGGCAAGCGTTGTCCGGATTTACTGGGCGTAAAGGGCGCGTAGGCGGCCTGTTAAGTGTGAAGTGAAATCTCCAGAGCTCAACTCGGAAACTGCTTTACATACTGGCATGGCTTGAGGAATGCAGAGGTGAATAGAATTCCT	False
TACGGAGGGTGCAAGCGTTGTTCGGAATTACTGGGCGTAAAGCGCGCGTAGGCGGTTTGCTAAGTCAGATGTGAAAGCCCATGGCTCAACCATGGACGTGCATTTGAAACTGGCAGACTTGAGTATTGGAGGGGGTGGTGGAATTCCCGG	False
TACGGAGGGTGCAAGCGTTAATCGGAATTACTGGGCGTAAAGCGCACGCAGGCGGTCTGTCAAGTCGGATGTGAAATCCCCGGGCTCAACCTGGGAACTGCATTCGAAACTGGCAGGCTGGAGTCTTGTAGAGGGGGGTAGAATTCCAGG	False
TACGTAGGGTCCAAGCGTTAATCGGAATTACTGGGCGTAAAGCGTGCGCAGGCGGTTGTGCAAGACCGATGTGAAATCCCCGGGCTTAACCTGGGAATTGCATTGGTGACTGCACGGCTAGAGTGTGTCAGAGGGGGGTAGAATTCCACG	False
TACGAAGGGGGCTAGCGTTGCTCGGAATCACTGGGCGTAAAGGGTGCGTAGGCGGGTCTTTAAGTCAGGGGTGAAATCCTGGAGCTCAACTCCAGAACTGCCTTTGATACTGAAGATCTTGAGTTCGGGAGAGGTGAGTGGAACTGCGAG	False
TACGTAGGGTGCAAGCGTTAATCGGAATTACTGGGCGTAAAGCGTGCGCAGGCGGTTATGCAAGACAGAGGTGAAATCCCCGGGCTCAACCTGGGAACTGCCTTTGTGACTGCATGGCTAGAGTACGGTAGAGGGGGATGGAATTCCGCG	False
TACGTAGGGAGCAAGCGTTATCCGGATTTATTGGGTGTAAAGGGTGCGTAGACGGGTATATAAGTTAGTTGTGAAATCCCTCGGCTCAACTGAGGAACTGCAACTAAAACTGTAAATCTTGAGTGCGGGAGAGGAAAGTGGAATTCCTAG	False
TACGTAGGGGGCAAGCGTTATCCGGAATTACTGGGTGTAAAGGGAGCGTAGACGGCAATGCAAGTCCGGAGTGGAATGCGGCAGCTCAACTGCCGAACTGCTCTGGAAACTGTATGGCTTGAGTGCAGGAGGGGTAAGCGGAATTCCTGG	False
TACGTAGGGAGCAAGCGTTATCCGGAATTATTGGGTGTAAAGGGTGCGTAGACGGGATAACAAGTTGGTTGTGAAACCCCTCGGCTCAACTGAGGAACTGCAACCAAAACTATTATTCTTGAGTGCAGGAGAGGAAAGTGGAATTCCTAG	True
TACGTAGGGTGCGAGCGTTAATCGGAATTACTGGGCGTAAAGCGTGCGCAGGCGGTTTTGTAAGACAGGCGTGAAATCCCCGGGCTCAACCTGGGAACTGCGCTTGTGACTGCAAGGCTAGAGTATGGCAGAGGGGGGTGGAATTCCACG	False
TACGGAGGGTGCAAGCGTTAATCGGAATTACTGGGCGTAAAGCGCACGCAGGCGGTTGGATAAGTTAGATGTGAAAGCCCCGGGCTCAACCTGGGAATTGCATTTAAAACTGTCCAGCTAGAGTCTTGTAGAGGGGGGTAGAATTCCAGG	False
TACAGAGGGTGCGAGCGTTAATCGGATTTACTGGGCGTAAAGCGCGCGTAGGTGGTTAATTAAGTCAAATGTGAAATCCCCGAGCTTAACTTGGGAATTGCATTCGATACTGGTTAGCTAGAGTATGGGAGAGGATGGTAGAATTCCAGG	False
TACGTAGGGGGCAAGCGTTATCCGGATTTACTGGGTGTAAAGGGAGCGTAGACGGCCATTCAAGCCAGATGTGAAAGCCCGGGGCTCAACCCCGGGACTGCATTTGGAACTGTGTGGCTAGAGTGTCGGAGAGGCAGGCGGAATTCCTAG	False
TACGTAGGGAGCGAGCGTTATCCGGATTCATTGGGCGTAAAGCGCGCGTAGGCGGCTGCCTAAGCGGAACCTCTAATCCCGGGGCTCAACCTCGGGCCGGGTTCCGAACTGGGCGGCTCGAGTGCGGTAGAGGCAGGCGGAATTCCCGGT	True
TACGTAGGGGGCAAGCGTTATCCGGATTTACTGGGTGTAAAGGGAGCGTAGACGGCGAAGAAAGTCTGAAGTGAAAGCCCGCGGCTTAACCGCGGAACTGCTTTGGAAACTTTTTTGCTGGAGTACCGGAGAGGTAAGCGGAATTCCTAG	False
TACGTAGGTCCCGAGCGTTATCCGGATTTATTGGGCGTAAAGCGAGCGCAGGCGGTTGGATAAGTCTGAAGTTAAAGGCTGTGGCTCAACCATAGTATGCTTTGGAAACTGTTCAACTTGAGTGCAGAAGGGGAGAGTAGAATTCCATGT	False
TACGGAGGGGGCTAGCGTTGTTCGGAATTACTGGGCGTAAAGCGCACGTAGGCGGACTGGAAAGTCAGAGGTGAAATCCCAGGGCTCAACCTTGGAACTGCCTTTGAAACTATCAGTCTGGAGTTCGAGAGAGGTGAGTGGAATTCCGAG	False
TACGTAGGGGGCAAGCGTTGTCCGGAATTATTGGGCGTAAAGCGCGCGCAGGCGGCCTTTTAAGTCTGATGTGAAATCTTGCGGCTCAACCGCAAGCGGTCATTGGAAACTGGGAGGCTTGAGTACAGAAGAGGAGAGTGGAATTCCATG	False
TACGTAGGGGGCAAGCGTTGTCCGGAATTATTGGGCGTAAAGCGCGCGCAGGCGGTCTCTTAAGTCTGATGTGAAATCTTGCGGCTCAACCGCAAGCGGTCATTGGAAACTGGGAGACTTGAGTACAGAAGAGGAGAGTGGAATTCCATG	False
TACGTAGGTGGCAAGCGTTGTCCGGAATTATTGGGCGTAAAGCGCGCGCAGGCGGTTCTTTAAGTCTGATGTGAAAGCCCACGGCTCAACCGTGGAGGGTCATTGGAAACTGGGGAACTTGAGTGCAGAAGAGGAAAGTGGAATTCCATG	False
TACGTAGGGTGCAAGCGTTAATCGGAATTACTGGGCGTAAAGCGTGCGCAGGCGGTTTTGTAAGACAGGCGTGAAATCCCCGGGCTCAACCTGGGAATGGCGCTTGTGACTGCAAAGCTGGAGTGCGGCAGAGGGGGATGGAATTCCGCG	False
TACGGAGGGGGCTAGCGTTGTTCGGAATTACTGGGCGTAAAGCGCACGTAGGCGGACTGGAAAGTTGGAGGTGAAATCCCAGGGCTCAACCTTGGAACTGCCTTCAAAACTATCAGTCTGGAGTTCGAGAGAGGTGAGTGGAATTCCGAG	False
TACGGGAGTGGCAAGCGTTATCCGGAATTATTGGGCGTAAAGCGTCCGCAGGCGGTTTTACAAGTCTGTCGTTAAAACGTGGAGCTCAACTCCATTTCGGCGATGGAAACTGTAAGACTAGAGTGTGGTAGGGGCAGAGGGAATTCCCGG	False
TACGTAGGGTGCAAGCGTTAATCGGAATTACTGGGCGTAAAGCGTGCGCAGGCGGTTGTGCAAGACAGATGTGAAATCCCCGGGCTCAACCTGGGAACTGCATTTGTGACTGCACAGCTAGAGTACGGTAGAGGGGGATGGAATTCCGCG	False
TACGTAGGGTGCGAGCGTTAATCGGAATTACTGGGCGTAAAGCGTGCGCAGGCGGGCTTTTAAGCCAGACGTGAAATCCCCGGGCTTAACCTGGGAATGGCGTTTGGGACTGGGAGCCTAGAGTGCGGCAGAGGGGGGTGGAATTCCAGG	False
TACGTAGGGGGCAAGCGTTGTCCGGAATTATTGGGCGTAAAGCGCGCGCAGGCGGCCTTTTAAGTCTGATGTGAAATCTTGCGGCTCAACCGCAAGCGGTCATTGGAAACTGGGAGGCTTGAGTGCAGAAGAGGAGAGTGGAATTCCATG	False
TACGTAGGGGGCGAGCGTTGTCCGGAATTACTGGGCGTAAAGAGTTCGTAGGCGGTCTGATAAGTCAGATGTGAAAGGCGTAGGCTCAACCTATGTAAGCATATGAAACTGTCAGACTTGAGGTAAGGAGAGGAAAGTGGAATTCCTAGT	False
TACGTAGGTGGCAAGCGTTGTCCGGAATTATTGGGCGTAAAGCGCGCGCAGGCGGCCTCTTAAGTCTGATGTGAAAGCCCCCGGCTCAACCGGGGAGGGCCATTGGAAACTGGGAGGCTTGAGTATAGGAGAGAAGAGTGGAATTCCACG	False
TACGTAGGTAGCAAGCGTTGTCCGGAATTACTGGGTGTAAAGGGAGCGTAGGCGGGATTGCAAGTTGAATGTGAAATCTATGGGCTCAACCCATAGCTGCGTTCAAAACTGCAGTTCTTGAGTGAAGTAGAGGCAGGCGGAATTCCTAGT	False
TACGTAGGTGGCGAGCGTTGTCCGGAATTACTGGGCGTAAAGGATGCGTAGGTGGATATTTAAGTGGGATGTGAAATCCCCGGGCTCAACCCGGGAACTGCATTCCAAACTGGGTATCTAGAGTGCAGGAGAGGAAAGCGGAATTCCTAG	False
TACGTAGGTGGCGAGCGTTGTCCGGAATTACTGGGCGTAAAGGATGCGTAGGTGGATACTTAAGTGGGATGTGAAATCCCCGGGCTCAACCCGGGAACTGCATTCCAAACTGGGTATCTAGAGTGCAGGAGAGGAAAGCGGAATTCCTAG	False
TACGGAGGGGGCTAGCGTTGTTCGGAATTACTGGGCGTAAAGCGCACGTAGGCGGACTGGAAAGTTGGAGGTGAAATCCCAGGGCTCAACCTTGGAACTGCCTTCAAAACTATCAGTCTGGAGTTCGAGAGAGGTGAGTGGAATTCAGAG	False
TACGTAGGTGGCAAGCGTTGTCCGGATTTATTGGGCGTAAAGGGAGCGCAGGTGGTTTCTTAAGTCTGATGTGAAAGCCCACGGCTTAACCGTGGAGGGTCATTGGAAACTGGGAAACTTGAGTACAGAAGAGGAATGTGGAACTCCATG	False
TACGTAGGTGGCGAGCGTTATCCGGATTTATTGGGCGTAAAGCGTCCGCAGCCGGTTTATTAAGTATAGAATAAAACTTCGGGGCTCAACCCCGTCTCGTTCTATAAACTGATAGACTAGAGTGTGGTAGAGGCAAGTGGAATTTCTAGT	False
TACGTAGGTGGCAAGCGTTATCCGGATTTATTGGGTGTAAAGGGCGTGTAGGCGGGAAAGCAAGTCAGATGTGAAAACTCAGGGCTCAACCCTGAGCCTGCATTTGAAACTGTTTTTCTTGAGTGCTGGAGAGGCAATCGGAATTCCGTG	False
TACGTATGGGGCAAGCGTTATCCGGATTTACTGGGTGTAAAGGGAGCGTAGGCGGCAGGGCAAGCCTGATGTGAAAGCCCGGGGCTCAACCCCGGGACTGCATTGGGAACTGCCCCGCTCGAGTGCCGGAGGGGCAGGCGGAATTCCTAG	False
TACGTAGGAGGCAAGCGTTATCCGGAATGACTGGGCGTAAAGGGTGCGTAGGTGGTTTGACAAGTTAGTAGCGCAACTCCGGAGCTTAACTTCGGAACTACTACTAAAACTGTTGGACTTGAGTGCAGGAGGGGCAATCGGAATTCCTAG	False
TACGTAGGGAGCAAGCGTTATCCGGATTTATTGGGTGTAAAGGGTGCGTAGACGGGATAACAAGTTAGTTGTGAAAACCCTCGGCTCAACTGAGGAACTGCAACTAAAACTATTATTCTTGAGTGCAGGAGGGGAAAGTGGAATTCCTAG	False
TACGTAGGTGGCAAGCGTTGTCCGGATTTACTGGGTGTAAAGGGCGTGTAGCCGGGCTGACAAGTCAGATGTGAAATCCCGTGGCTCAACCACGGAACTGCATTTGAAACTGTCGGTCTTGAGTATCGGAGAGGCAGGCGGAATTCCTAG	False
TACGGAGGATGCGAGCGTTATCCGGATTTACTGGGTGTAAAGGGGGCGCAGACGGCGATGCAAGCCAGGAGTGAAAGCCCGCGGCCCAACCGCGGGACTGCATTGGGAACTACCGGGCTGGAGTGCCGGAGAGGTAGGCGGAATTCCTAG	False
TACGTAGGGGGCAAGCGTTATCCGGAATTATTGGGCGTAAAGAGTGCGTAGGTGGTTACCTAAGCAGGGGGTGAAAGGCAATGGCTCAACCATTGTTAGCCCTCTGAACTGGGTTACTTGAGTGCAGGAGAGGAAAGCGGAATTCCTAGT	False
TACGTAGGTGGCAAGCGTTGTCCGGATTTACTGGGTGTAAAGGGCGTGCAGCCGGAGAGACAAGTCAGATGTGAAATCCACGGGCTCAACCCGTGAACTGCATTTGAAACTGTAGTTCTTGAGTACTGGAGAGGCAGACGGAATTCCTAG	False
TACGTAGGGTGCGAGCGTTAATCGGAATTACTGGGCGTAAAGCGTGCGCAGGCGGTTATACAAGACAGGCGTGAAATCCCCGGGCTTAACCTGGGAATGGCGCCTGTGACTGTATAGCTAGAGTGTGTCAGAGGGGGGTAGAATTCCACG	False
TACGGAGGGTGCAAGCGTTATCCGGATTTATTGGGTTTAAAGGGTCCGTAGGCGGATCTGTAAGTCAGTGGTGAAATCTCACAGCTTAACTGTGAAACTGCCATTGATACTGCAGGTCTTGAGTAAATTTGAAGTGGCTGGAATAAGTAG	False
TACGGAGGGTGCAAGCGTTAATCGGAATTACTGGGCGTAAAGCGCACGCAGGCGGTCTGTCAAGTCGGATGTGAAATCCCCGGGCTCAACCTGGGAACTGCATTCGAAACTGGCAGGCTAGAGTCTTGTAGAGGGGGGTAGAATTCCAGG	False
TACGTAGGTGGCAAGCGTTATCCGGATTTACTGGGTGTAAAGGGCGTGTAGGCGGGAAAGCAAGTCAGATGTGAAAACCACGGGCTCAACCTGTGGCCTGCATTTGAAACTGTTTTTCTTGAGTACTGGAGAGGCAGACGGAATTCCTAG	True
TACGTAGGTGGCGAGCGTTATCCGGATTTACTGGGTGTAAAGGGCGTGTAGGCGGGATTGCAAGTCAGATGTGAAAACTATGGGCTCAACCCATAGCCTGCATTTGAAACTGTAGTTCTTGAGTGCTGGAGAGGCAATCGGAATTCCGTG	False
TACGTAGGGGGCAAGCGTTATCCGGATTTACTGGGTGTAAAGGGAGCGTAGACGGCTATGCAAGTCTGGAGTGAAAGGCGGGGGCCCAACCCCCGGACTGCTCTGGAAACTGTAGAGCTAGAGTGCAGGAGAGGTAAGTGGAATTCCTAG	False
TACGTAGGTGGCGAGCGTTATCCGGAATGATTGGGCGTAAAGGGTGCGCAGGCGGTTGTATAAGTCTGAAGTAAAAGCCATCGGCTCAACCGATGTAAGCTTTGGAAACTGTGTAACTAGAGTGCAGGAGAGGGCAGTGGAATTCCATGT	True
TACGTAGGGGGCAAGCGTTATCCGGATTTACTGGGTGTAAAGGGAGCGCAGGTGGCATGGCAAGCCAGAAGTGAAAACCCGGGGCTTAACTCCGCGGATTGCTTTTGGAACTGTCAGGCTGGAGTGCAGGAGGGGCAGGCGGAATTCCTG	False
TACGTAGGTGGCGAGCGTTGTCCGGATTTACTGGGTGTAAAGGGCGCGTAGGCGGATTTGCAAGTCAGATGTGAAATACCGGGGCTTAACTCCGGAACTGCATTTGAAACTGTAGACCTTGAGTGCCGGAGAGGAAAGCGGAATTCCTAG	True
TACGTAGGGGGCAAGCGTTATCCGGATTTACTGGGTGTAAAGGGAGCGTAGACGGAGAAGCAAGTCTGAAGTGAAAGCCCGTGGCTTAACCACGGGACTGCTTTGGAAACTGTTTGACTAGAGTGCTGGAGAGGTAAGTGGAATTCCTAG	False
TACGTAGGGGGCAAGCGTTATCCGGATTTACTGGGTGTAAAGGGAGCGTAGACGGCGTGCCAAGTCTGGTGTGAAAGCCCGGGGCCCAACCCCGGGACTGCTCTTGGAACTGCGTGGCTGGAGTGCAGGAGGGGCAGGCGGAATTCCTGG	False
TACGTAGGGGGCGAGCGTTATCCGGATTTATTGGGCGTAAAGGGTGCGTAGGCGGTATGTTAAGTCTAAAATCAAAGCCCGAGGCTTAACCTCGGTTCGTTTTAGAAACTGGCAAACTAGAGTGCAGTAGAGGCAAGTGGAATTTCTAGT	False
TACGTAGGGAGCAAGCGTTATCCGGATTTATTGGGCGTAAAGGGTGCGTAGACGGGAAGGCAAGTTGGTTGTGAAATCCCTCGGCTTAACTGAGGAACTGCAACCAAAACTATCTTTCTTGAGTGCTGGAGAGGAAAGTGGAATTCCTAG	False
TACGTAGGGGGCAAGCGTTATCCGGATTTACTGGGTGTAAAGGGAGCGTAGACGGCATGGCAAGCCAGATGTGAAATACCGGGGCTCAACCCCGGGACTGCATTTGGAACTGTTAAGCTGGAGTGTCGGAGAGGCAGGCGGAATTCCTAG	True
TACGTAGGGAGCGAGCGTTGTCCGGATTTACTGGGTGTAAAGGGCGTGTAGGCGGAGCTGCAAGTCAGAAGTGAAATCTCCGGGCTCAACCCGGAAACTGCTTTTGAAACTGTAGCCCTTGAGTATCGGAGAGGCAGGCGGAATTCCTAA	False
TACGTAGGGGGCGAGCGTTATCCGGATTTACTGGGTGTAAAGGGAGCGTAGACGGCGTCGCAAGTCTGAAGTGAAAGCCCGTGGCTCAACCGCGGAACCGCTTTGGAAACTGCGAGGCTGGAGTGCTGGCGAGGTAAGCGGAATTCCTGG	False
TACGTAGGGTGCGAGCGTTAATCGGAATTACTGGGCGTAAAGCGTGCGCAGGCGGTTGTGCAAGACAGATGTGAAATCCCCGGGCTCAACCTGGGAACTGCATTTGTGACTGCACGACTAGAGTACGGCAGAGGGGGGTAGAATTCCACG	False
TACGTAGGGGGCAAGCGTTATCCGGATTTACTGGGTGTAAAGGGAGCGTAGACGGCGATGCAAGTCTGAAGTGAAAGCCCGGGGCTCAACCCCGGGACTGCTTTGGAAACTGTATGGCTGGAGTGCTGGAGAGGCAAGCGGACTTCCTAG	False
TACGGAGGGTGCAAGCGTTATCCGGATTTATTGGGTTTAAAGGGTCCGTAGGCGGACTTATAAGTCAGTGGTGAAAGCCTGTCGCTTAACGATAGAACTGCCATTGATACTGTAAGTCTTGAGTATATTTGAGGTAGCTGGAATAAGTAG	False
TACAGAGGATGCAAGCGTTATCCGGAATGATTGGGCGTAAAGCGTCTGTAGGTGGCTTTTTAAGTCCGCCGTCAAATCCCAGGGCTCAACCCTGGACAGGCGGTGGAAACTACCAAGCTGGAGTACGGTAGGGGCAGAGGGAATTTCCGG	False
TACGTAGGTGGCAAGCGTTGTCCGGATTTACTGGGTGTAAAGGGCGTGCAGCCGGGAAGACAAGTCAGATGTGAAATCCCGCGGCTCAACCGCGGAACTGCATTTGAAACTGTTTTTCTTGAGTATCGGAGAGGTAACCGGAATTCCTAG	False
TACGTATGGGGCAAGCGTTATCCGGATTTACTGGGTGTAAAGGGAGCGCAGGCGGCCTGCCAAGTCTGGTGTGAAAACCCGGGGCCCAACCCCGGGCCTGCATTGGAAACTGGCGGGCTGGAGTGTCGGAGGGGCAGGCGGAATTCCTAG	False
TACGTAGGGGGCAAGCGTTATCCGGAATTACTGGGTGTAAAGGGAGCGTAGGCGGTGATGCAAGTCAGATGTGAAAACCCGGGGCTCAACCCCGGGAGTGCATTTGAAACTGTGTGACTGGAGTGCAGGAGAGGCAAGTGGAATTCCTAG	True
TACGGAGGGTGCAAGCGTTAATCGGAATTACTGGGCGTAAAGCGTGCGTAGGCGGTTATTTAAGTCAGATGTGAAAGCCCCGGGCTTAACCTGGGAACTGCATTTGATACTGGGTAACTAGAGTTGAGTAGAGGAGAGTGGAATTTCAGG	False
TACGTAGGTCCCGAGCGTTGTCCGGATTTATTGGGCGTAAAGCGAGCGCAGGCGGTTTAATAAGTCTGAAGTTAAAGGCAGTGGCTTAACCATTGTTCGCTTTGGAAACTGTTAGACTTGAGTGCAGAAGGGGAGAGTGGAATTCCATGT	False
TACAGAGGGTGCAAGCGTTAATCGGATTTACTGGGCGTAAAGCGTGCGTAGGTGGCCAATTAAGTCAAATGTGAAATCCCCGAGCTTAACTTGGGAATTGCATTCGATACTGGTTGGCTAGAGTATGGGAGAGGATGGTAGAATTCCAGG	False
TACGTAGGGTGCAAGCGTTAATCGGAATTACTGGGCGTAAAGCGAGCGCAGGCGGTTTTGTAAGTCAGATGTGAAAGCCCCGGGCTCAACCTGGGAACTGCGTTTGAAACTACAAGGCTAGAGTATGGGAGAGGGGGGTAGAATTCCACG	False
TACAGAGGGTGCGAGCGTTAATCGGATTTACTGGGCGTAAAGCGTGCGTAGGTGGCCAATTAAGTCAAATGTGAAATCCCCGAGCTTAACTTGGGAATTGCATTCGATACTGGTTGGCTAGAGTATGGGAGAGGATGGTAGAATTCCAGG	False
TACGAAGGGGGCTAGCGTTGCTCGGAATTACTGGGCGTAAAGGGAGCGTAGGCGGACATTTAAGTCAGAGGTGAAATCCCGGAGCTTAACTTCGGAACTGCCTTTGATACTGGGTGTCTTGAGTGTGAGAGAGGTATGTGGAACTCCGAG	False
TACAGAGGGTGCAAGCGTTAATCGGAATTACTGGGCGTAAAGCGCACGCAGGCGGTTGGTTAAGTCAGATGTGAAAGCCCCGGGCTCAACCTGGGAATTGCATTTGAAACTGGCCAACTAGAGTATGTGAGAGGGGGGTAGAATTCCAAG	False
TACAGAGGGTGCGAGCGTTAATCGGATTTACTGGGCGTAAAGCGTGCGTAGGCGGCTGATTAAGTCGGATGTGAAATCCCTGAGCTTAACTTAGGAATTGCATTCGATACTGGTCAGCTAGAGTATGGGAGAGGATGGTAGAATTCCAGG	False
TACGAAGGGTGCAAGCGTTAATCGGAATTACTGGGCGTAAAGCGCGCGTAGGTGGTTCGTTAAGTTGGATGTGAAAGCCCCGGGCTCAACCTGGGAACTGCATCCAAAACTGGCGAGCTAGAGTATGGCAGAGGGTGGTGGAATTTCCTG	False
TACGTAGGGAGCGAGCGTTATCCGGATTTATTGGGTGTAAAGGGTGCGTAGACGGGAAAACAAGTTAGTTGTGAAATCCCTCGGCTTAACTGAGGAACTGCAACTAAAACTATTTTTCTTGAGTGCAGGAGAGGTAAGTGGAATTCCTAG	False
TACGTAGGGGGCAAGCGTTATCCGGATTTACTGGGTGTAAAGGGAGCGTAGACGGCTGTGCAAGTCTGAAGTGAAATGCCGGGGCTCAACCCCGGAACTGCTTTGGAAACTGTACAGCTAGAGTGCAGGAGGGGTGAGCGGAATTCCTAG	False
TACGTAGGGGGCAAGCGTTATCCGGATTTACTGGGTGTAAAGGGAGCGTAGGTGGCAGGGCAAGTCAGATGTGAAAACCCGGGGCTCAACCCCGGGAGTGCATTTGAAACTGTCCAGCTGGAGTGCAGGAGAGGTAAGCGGAATTCCTAG	False
TACGTATGGGGCAAGCGTTATCCGGATTTACTGGGTGTAAAGGGAGCGTAGGCGGTACGGCAAGTCAGAAGTGAAAGCCTGGGGCTCAACCCCGGAATTGCTTTTGAAACTGTCGAACTAGAGTGTCGGAGGGGTAAGCGGAATTCCTAG	False
TACAGAGGGTGCGAGCGTTAATCGGATTTACTGGGCGTAAAGCGTGCGTAGGCGGCTTTTTAAGTCGGATGTGAAATCCCCGAGCTTAACTTGGGAATTGCATTCGATACTGGGAAGCTAGAGTATGGGAGAGGATGGTAGAATTCCAGG	False
TACGTAGGGAGCGAGCGTTGTCCGGAATTACTGGGTGTAAAGGGAGTGTAGGCGGGATGGTAAGTTAGGTGTGAAATGCGGAGGCTCAACCTCCGAGCTGCACTTAAAACTGCTGTTCTTGAGTGAAGTAGAGGTTGGCGGAATTCCCAG	False
TACGGAGGGTGCGAGCGTTAATCGGAATTACTGGGCGTAAAGCGCGCGTAGGCGGTTGGCTAAGTTTGCTGTGAAAGCCCCGGGCTTAACCTGGGAACTGCAGTGAATACTGGTCAGCTAGAGTATGGTAGAGGGTAGTGGAATTTCCGG	False
TACGGAGGATGCGAGCGTTATCCGGATTTATTGGGTTTAAAGGGTGCGTAGGCGGCCTGCCAAGTCAGCGGTAAAATTGCGGGGCTCAACCCCGTACAGCCGTTGAAACTGCCGGGCTCGAGTGGGCGAGAAGTATGCGGAATGCGTGGT	False
TACGTAGGGGGCAAGCGTTATCCGGATTTACTGGGTGTAAAGGGAGCGTAGGCGGTTTAGCAAGTCAGAAGTGAAAGCCCGGGGCTCAACTCCGGGACTGCTTTTGAAACTGTTGAACTAGATTGCAGGAGAGGTAAGTGGAATTCCTAG	False
TACGTAGGTGGCGAGCGTTATCCGGAATCATTGGGCGTAAAGAGGGAGCAGGCGGCAGTCAGGGTCTGCGGTGAAAGCCCGAAGCTAAACTTCGGTAAGCCGTGGAAACCGGACAGCTAGAGAGCATCAGAGGATCGTGGAATTCCATGT	True
TACGTAGGTGGCAAGCGTTGTCCGGAATTACTGGGTGTAAAGGGAGCGTAGGCGGGAATGCAAGTTGAATGTTTAAACTATGGGCTCAACCCATAGTCGCGTTCAAAACTGCATTTCTTGAGTGGAGTAGAGGCAGGCGGAATTCCTAGT	True
TACGTATGGTGCGAGCGTTGTCCGGATTTACTGGGCGTGAAGGGGGCGCAGGCGGCGCGCCAAGCCCGATGTGAAAGCCCGGGGCTCAACCCCGGGACTGCATTGGGAACTGGCGGGCTGGAGTGCCGGAGGGGCAGGCGGAATTCCTGG	True
TACGTATGGTGCGAGCGTTGTCCGGATTTACTGGGCGTGAAGGGGGCGCAGGCGGCGCGCCAAGCCCGATGTGAAAGCCCGGGGCTCAACCCCGGGACTGCATTGGGAACTGGCGTGCTGGAGTGCCGGAGGGGCAGGCGGAATTCCTGG	True
TACGTAGGGTGCGAGCGTTGTCCGGAATTACTGGGCGTAAAGGGCTCGTAGGTGGTTTGTCGCGTCGTCTGTGAAATTCCGGGGCTTAACTCCGGGCGTGCAGGCGATACGGGCATAACTTGAGTACTGTAGGGGTAACTGGAATTCCTG	False
TACGTAGGTGGCAAGCGTTATCCGGAATTACTGGGTGTAAAGGGTGTGTAGGCGGGGCTGCAAGTCAGATGTGAAAATTATGGGCTCAACCCATAACCTGCGTCTGAAACTGTAGCTCTTGAGAGTGGGAGAGGTAAACGGAATTCCCGG	True
TACGTAGGGGGCAAGCGTTATCCGGATTTACTGGGTGTAAAGGGAGCGTAGACGGCTAAGCAAGTCTGAAGTGAAAGCCCGGGGCTTAACCCCGGGACTGCTTTGGAAACTGTTAAGCTAGAGTGCTGGAGAGGTAAGTGGAATTCCTAG	False
TACGTAGGGCGCGAGCGTTGTCCGGAATTATTGGGCGTAAAGAGCTTGTAGGCGGTTTGTCGCGTCTGCTGTGAAAGGCCGGGGCTTAACCCCGTGTATTGCAGTGGGTACGGGCAGACTAGAGTGCAGTAGGGGAGACTGGAACTCCTG	False
TACGTAGGAGGCAAGCGTTATCCGGAATGACTGGGCGTAAAGGGTGCGTAGGTGGTTTGACAAGTTGGTAGCGTAACTCCGAGGCTTAACCTCGGCACTACTACCAAAACTGTTGGACTCGAGTGCAGGAGGGGCAAATGGAATTCCTAG	False
TACGGAGGGTGCGAGCGTTAATCGGAATTACTGGGCGTAAAGCGCGCGTAGGCGGTTGGCTAAGTTTGCTGTGAAAGCCCCGGGCTTAACCTGGGAACTGCAGTGAATACTGGTCGGCTAGAGTATGGTAGAGGGTAGTGGAATTTCCGG	False
TACGTAGGGGGCAAGCGTTATCCGGATTTACTGGGTGTAAAGGGAGCGTAGGTGGCAAGGCAAGCCAGAAGTGAAACCCCGGGGCTTAACCCCGCGGATTGCTTTTGGAACTGTCTGGCTGGAGTGCAGGAGGGGCAGGCGGAATTCCTG	False
TACGTAGGTGGCAAGCGTTATCCGGATTTATTGGGCGTAAAGGGAACGCAGGCGGTCTTTTAAGTCTGATGTGAAAGCCTTCGGCTTAACCGGAGTAGTGCATTGGAAACTGGGAGACTTGAGTGCAGAAGAGGAGAGTGGAACTCCATG	False
TACGTAGGGGGCGAGCGTTATCCGGATTTACTGGGTGTAAAGGGAGCGTAGACGGCGTCGCAAGTCTGAAGTGAAAGCCCGTGGCTCAACCGCGGAACCGCTTTGGAAACTGTGAGGCTGGAGTGCTGGAGAGGTAAGCGGAATTCCTGG	False
TACGTAGGGGGCAAGCGTTATCCGGATTTACTGGGTGTAAAGGGAGCGTAGACGGTAGAGCAAGTCTGAAGTGAAAGCCCGCGGCTCAACTGCGGGACTGCTTTGGAAACTGTTCAACTGGAGTGCTGGAGAGGTAAGCGGAATTCCTAG	True
TACGTAGGTGGCAAGCGTTGTCCGGAATTACTGGGTGTAAAGGGAGCGTAGGCGGGAAGCCAAGTCAGCTGTGAAAACTACGGGCTTAACCTGTAGACTGCAGTTGAAACTGGCTTTCTTGAGTGAAGTAGAGGTTGGCGGAATTCCGAG	True
TACATAGGGAGCGAGCGTTATCCGGATTTATTGGGTGTAAAGGGTGCGTAGACGGGAATTTAAGTTGGTTGTGAAATCCCTCGGCTCAACCGAGGAACTGCAACCAAAACTGGATTTCTTGAGTACTGGAGAGGAAAGTGGAATTCCTAG	True
TACGTAGGTGGCGAGCGTTATCCGGATTTATTGGGCGTAAAGCGTGCGCAGGCGGTTTATTAAGTCTAAGATTAAAGCCCGGAGCTTAACTCCGGTTCGTCTTAGAAACTGGTAGACTTGAGTATGGTAGAGGCAAATGGAATTCCTAGT	True
TACGTAGGGTGCGAGCGTTAATCGGAATTACTGGGCGTAAAGCGTGCGCAGGCGGTTGTGTAAGACAGACGTGAAATCCCCGGGCTCAACCTGGGAACTGCGTTTGTGACTGCACGGCTAGAGTGTGGCAGAGGGGGGTGGAATTCCACG	False
TACGTAGGTGGCAAGCGTTGTCCGGATTTACTGGGTGTAAAGGGCGTGTAGGCGGGATGGTAAGTCAGATGTGAAATACCGGGGCTCAACTCCGGGGCTGCATTTGAAACTGCCGTTCTTGAGTGTCGGAGAGGAAAGCGGAATTCCTAG	False
TACGGAGGATGCGAGCGTTATCCGGATTTACTGGGTGTAAAGGGAGCGCAGGCGGTACGGCAAGTCTGATGTGAAAGCCCGGGGCCCAACCCCGGGACTGCTCTTGGAACTGCGTGGCTGGAGTGCAGGAGGGGCAGGCGGAATTCCTGG	False
TACGGAGGATGCGAGCGTTATCCGGATTTACTGGGTGTAAAGGGGGCGCAGACGGCGATGCAAGCCAGGAGTGAAAGCCCGGGGCTCAACCCCGGTACTGCATTGGAAACTGTCGGACTAGAGTGTCGGAGGGGTAAGTGGAATTCCTAG	False
TACGTATGGAGCAAGCGTTATCCGGATTTACTGGGTGTAAAGGGAGCGTAGGCGGCTCTGTAAGTCTGATGTGAAAATTTGGGGCTCAACCCCAAACGTGCATTGGAAACTGCAGGGCTTGAGTGCCGGAGAGGCAGGCGGACTTCCTAG	False
TACGGAGGATGCGAGCGTTATCCGGATTTATTGGGTTTAAAGGGTGCGTAGGCGGATTTTTAAGTCAGCGGTAAAATGTCCGGGCTCAACCCGGGCCGGCCGTTGAAACTGGGGATCTTGAGTGGGCGAGAAGTATGCGGAATGCGTGGT	True
TACGTAGGGGGCAAGCGTTATCCGGATTTACTGGGTGTAAAGGGAGCGTAGGCGGTTTGGCAAGTCAGAAGTGAAAGCCCGAGGCTCAACCACGGGACTGCTTTTGAAACTGTTAGACTAGATTGCAGGAGAGGTAAGTGGAATTCCTAG	True
TACGTAGGGGGCAAGCGTTATCCGGATTTACTGGGTGTAAAGGGAGCGTAGACGGCAGCGCAAGTCTGGAGTGAAACGTATGAGCTCAACTCATGCATGGCTCTGGAAACTGGAGGACTGGAGAGCAGGAGAGGGCGGTGGAACTCCATG	False
TACGTAGGGGGCAAGCGTTATCCGGATTTACTGGGTGTAAAGGGAGCGTAGACGGCAGTGCAAGCCTGGAGTGAAAGGATGGGGCCCAACCCCATGACTGCTCTGGGAACTGTACAGCTAGAGTGCCGGAGGGGTAAGCGGAATTCCTAG	False
TACGTAGGTGGCGAGCGTTGTCCGGATTTACTGGGCGTAAAGGGAGCGTAGGCGGACTTTTAAGTGAGATGTGAAATACTCGGGCTCAACTTGAGTGCTGCATTTCAAACTGTAAGTCTAGAGTGCAGGAGAGGAGAATGGAATTCCTAG	False
TACGTAGGGGGCAAGCGTTATCCGGATTTACTGGGTGTAAAGGGGGCGCAGACGGCAATGCAAGCCAGGAGTGAAAGCCCGGGGCCCAACCCCGGGACTGCTCTTGGAACTGCATGGCTGGAGTACAGGAGGGGCAGGCGGAATTCCTAG	False
TACGTAGGTGGCGAGCGTTATCCGGAATGATTGGGCGTAAAGGGTGCGCAGGCGGTCCTGCAAGTCTGGAGTGAAACGTATGAGCTCAACTCATGCATGGCTCTGGAAACTGGCAGGCTGGAGTGTCGGAGAGGCAGGCGGAATTCCTAG	False
TACGGAGGATGCGAGCGTTATCCGGATTTATTGGGTTTAAAGGGTGCGTAGGCGGACAGTTAAGTCAGCGGTAAAATTGAGAGGCTCAACCTCTTCCCGCCGTTGAAACTGTTTTTCTTGAGTGCTGGAGAGGCAATCGGAATTCCGTGT	False
TACGTATGGACCAAGCGTTGTCCGGAATCATTGGGCGTAAAGGGTACGTAGGCGGTTAAATAAGTTAGAAGTGAAATCCCATAGCTCAACTATAGTAAGCTTCTAAAACTGTATAACTTGAGAAATGAAAGGGAAAGTGGAATTCCTAGT	False
TACAGAGGGTGCGAGCGTTAATCGGAATTACTGGGCGTAAAGCGAGTGTAGGTGGCTCATTAAGTCACATGTGAAATCCCCGGGCTTAACCTGGGAACTGCATGTGATACTGGTGGTGCTAGAATATGTGAGAGGGAAGTAGAATTCCAG	False
TACGTAGGGGGCAAGCGTTATCCGGATTTACTGGGTGTAAAGGGAGCGTAGACGGTATGGCAAGTCTGAAGTGAAAGCCCAGGGCTTAACCCTGGGACTGCTTTGGAAACTGTTAGACTAGAGTGCTGGAGAGGTAAGTGGAATTCCTAG	False
TACGTAGGGGGCAAGCGTTATCCGGATTTACTGGGTGTAAAGGGAGCGTAGACGGCGGTGCAAGTCTGGAGTGAAAGGCAGGGGCCCAACCCCTGGACTGCTCTGGAAACTGTAGTGCTGGAGTGCAGGAGAGGTAAGTGGAATTCCTAG	True
TACGTAGGTGGCAAGCGTTGTCCGGAATTATTGGGCGTAAAGCGCGCGCAGGCGGTTCCTTAAGTCTGATGTGAAAGCCCACGGCTCAACCGTGGAGGGTCATTGGAAACTGGGGGACTTGAGTGCAGAAGAGGAGAGCGGAATTCCACG	False
TACGTAGGGAGCAAGCGTTATCCGGATTTACTGGGTGTAAAGGGCGTGTAGGCGGGCATGCAAGCCAGAAGTGAAATCTGGGGGCTTAACCCCCAAACTGCTTTTGGAACTGCGTGTCTTGAGTGATGGAGAGGCAGGCGGAATTCCCAG	False
TACGTAGGTGGCAAGCGTTGTCCGGAATTACTGGGTGTAAAGGGAGCGTAGGCGGGAGGATAAGTTGGACGTATAAACTATCGGCTCAACCGGTAGAGGCGTTCAAAACTGTCCTTCTTGAGTGAAGTAGAGGTAAGCGGAATTCCTAGT	False
TACGTAGGGGGCGAGCGTTATCCGGATTCACTGGGCGTAAAGGGAGCGCAGGCGGCACGGCAAGTCCGGTGTGAAAGCCCGGGGCCCAACCCCGGGACTGCACTGGAAACTGCCGGGCTGGAGTGTCGGAGGGGCAGGCGGAATTCCTGG	False
TACGTATGGAGCAAGCGTTATCCGGATTTACTGGGTGTAAAGGGAGCGCAGACGGCAGGGCAAGTCTGATGTGAAAGTCCGGGGCTCAACCCCGGGACTGCATTGGAAACTGTCCGGCTAGAGTGCAGGAGAGGTAAGTGGAATTCCTAG	False
TACGTAGGGTGCGAGCGTTAATCGGAATTACTGGGCGTAAAGCGTGCGCAGGCGGTTGTGTAAGACAGGCGTGAAATCCCCGGGCTCAACCTGGGAACTGCGCTTGTGACTGCACAGCTAGAGTACGGCAGAGGGGGGTGGAATTCCACG	False
TACGTAGGGAGCGAGCGTTATCCGGATTTACTGGGTGTAAAGGGCGTGTAGGCGGGATGGCAAGTCAGGCGTGAAAACTATGGGCTCAACCCATAGCCTGCGTTTGAAACTGTCGTTCTTGAGTGATGGAGAGGCAAGCGGAATTCCGTG	False
TACGTAGGGAGCGAGCGTTGTCCGGATTTACTGGGTGTAAAGGGTGCGTAGGCGGCTATGCAAGTCAGTAGTGAAATCCATGGGCTTAACCCATGAACTGCTATTGAAACTGCACAGCTTGAGTGAAGTAGAGGTAGGCGGAATTCCCGG	True
TACGTAGGTGGCAAGCGTTGTCCGGAATTACTGGGTGTAAAGGGAGCGTAGGCGGGGCCGCAAGCCTCATGTGAAATCGACCGGCTCAACCGGTTGCTGCGTGAGGAACTGCGGTTCTTGAGTGGAGTAGAGGCAGGCGGAATTCCTAGT	False
TACGTAGGGTGCAAGCGTTAATCGGAATTACTGGGCGTAAAGCGTGCGCAGGCGGTTTTGTAAGACAGGCGTGAAATCCCCGGGCTCAACCTGGGAATTGCGCTTGTGACTGCAAAGCTGGAGTGCGGCAGAGGGGGATGGAATTCCGCG	False
TACGAAAGGTGCGAGCGTTAATCGGAATTACTGGGCGTAAAGCGCGCGTAGGCGGCTATTTAAGTCTGATGTGAAATCCCCGGGCTCAACCTGGGAATTGCATCGGATACTGACTAGCTAGAATGCGGTAGAGGGGGGTGGAATTCCAGG	False
TACGTAGGGTGCGAGCGTTAATCGGAATTACTGGGCGTAAAGCGTGCGCAGGCGGTGATATAAGACAGATGTGAAATCCCCGGGCTCAACCTGGGACCTGCATTTGTGACTGTATCGCTAGAGTACGGTAGAGGGGGATGGAATTCCGCG	False
TACGGAGGGTGCGAGCGTTAATCGGAATTACTGGGCGTAAAGCGCGCGTAGGCGGTTTGGTAAGCTGGATGTGAAAGCCCTGGGCTCAACCTGGGAACTGCGTCCAGAACTGCCAAGCTAGAGTATGGTAGAGGGCAGTGGAATTTCCGG	False
TACGAAGGGGGCTAGCGTTGTTCGGAATTACTGGGCGTAAAGCGCACGTAGGCGGACTTTTAAGTCAGGTGTGAAATCCCGGGGCTCAACCTCGGAACTGCATTTGAAACTGGAAGTCTTGAGATCAGGAGAGGTTAGCGGAATACCGAG	False
TACGAAGGGGGCTAGCGTTGCTCGGAATTACTGGGCGTAAAGGGCGCGTAGGCGGACATTTAAGTCAGGGGTGAAATCCCAGAGCTCAACTCTGGAACTGCCTTTGATACTGGGTGTCTTGAGTGTGAGAGAGGTATGTGGAACTCCGAG	False
TACGTAGGGTGCAAGCGTTGTCCGGAATTATTGGGCGTAAAGAGCTCGTAGGCGGCTTGTCGCGTCTGCTGTGAAAACCCGAGGCTCAACCTCGGGCTTGCAGTGGGTACGGGCAGGCTAGAGTGCGGTAGGGGAGATTGGAATTCCTGG	False
TACGTAGGGTGCGAGCGTTAATCGGAATTACTGGGCGTAAAGCGTGCGCAGGCGGATTGTTAAGCAAGATGTGAAATCCCCGGGCTTAACCTGGGAATGGCATTTTGAACTGGCAGTCTAGAGTGCGTCAGAGGGGGGTGGAATTCCACG	False
TACGAAGGGGGCTAGCGTTGCTCGGAATCACTGGGCGTAAAGGGTGCGTAGGCGGGTCTTTAAGTCAGAGGTGAAATCCTGGAGCTCAACTCCAGAACTGCCTTTGATACTGAGGATCTTGAGTTCGGGAGAGGTGAGTGGAACTGCGAG	False
TACGGAGGGGGCTAGCGTTGTTCGGAATTACTGGGCGTAAAGCGCACGTAGGCGGCTATCCAAGTTGGGGGTGAAATCCCTGGGCTTAACCCAGGAACTGCCTTCAAAACTGGATGGCTAGAGTCCGAGAGAGGTGAGTGGAATTTCCAG	False
TACGGAGGGTGCAAGCGTTATTCGGAATTACTGGGCGTAAAGCGCACGTAGGCCGCTTTGTAAGTCAGGGGTGAAATCCCACGGCTCAACCGTGGAACTGCCCTTGAAACTGCAGAGCTTGAATCCTGGAGAGGGTGGCGGAATTCCTGG	False
TACGAAGGGGGCTAGCGTTGTTCGGAATTACTGGGCGTAAAGCGCACGTAGGCGGACTTTTAAGTCAGGTGTGAAATCCCGGGGCTCAACCTCGGAACTGCATTTGAAACTGGAAGTCTTGAGACCAGGAGAGGTTAGCGGAATACCGAG	False
TACGAAGGGTGCAAGCGTTAATCGGAATTACTGGGCGTAAAGCGTGCGTAGGCGGTTTGTTAAGTCAGGTGTGAAAGCCCCGGGCTCAACCTGGGAACTGCATTTGATACTGGCAGGCTAGAGTACGGTAGAGGGTGGTGGAATTCCCGG	False
GACGAAGGGGGCTAGCGTTGTTCGGAATTACTGGGCGTAAAGGGCGCGTAGGCGGTTTGTTAAGTCAGGCGTGAAAGCCCTGGGCTCAACCTGGGATGTGCGTTTGATACTGGCAAGCTTGAGTGCAGGAGAGGATGGTGGAATTCCCAG	False
TACGTAGGGAGCAAGCGTTGTCCGGATTTACTGGGCGTAAAGGGCGTGTAGGCGGTCTGTTAAGTGTGACGTGAAATCTTCAGGGCTCAACCCGAAAATTGCGTCGCAGACTGGCAGACTAGAGGGAAGCAGAGGTTGATAGAATTCCTG	False
TACGTAGGTGGCGAGCGTTGTCCGGAATTACTGGGCGTAAAGGATGCGTAGGTGGATATTTAAGTGGGATGTGAAATCCCCGGGCTCAACCCGGGAACTGCATTCCAAACTGGATGTCTAGAGTGCAGGAGAGGAAAGCGGAATTCCTAG	False
TACGAAGGGGGCTAGCGTTGTTCGGAATTACTGGGCGTAAAGCGCACGCAGGCGGTCCGATTAGTCAGAAGTGAAAGCCCCGGGCTCAACCTGGGAACTGCTTTTGATACTGCCGGACTAGAATCACGGAGAGGGTAGTGGAATTCCGAG	False
TACGTAGGGTGCAAGCGTTAATCGGAATTACTGGGCGTAAAGCGTGCGCAGGCGGTTTTGTAAGACAGGCGTGAAATCCCCGGGCTCAACCTGGGAATGGCGCTTGTGACTGCAAGGCTGGAGTGCGGCAGAGGGGGATGGAATTCCGCG	False
TACGTAGGGGGCAAGCGTTATCCGGATTCATTGGGCGTAAAGAGCGCGTAGGCGGATTGTTAAGCGCGATGTGAAAACTGGGGGCTCAACCCGCAGCCTGCATCGTGAACTGGCAGTCTTGAGTCTGGTAGAGGAGTGTGGAATTCCCAG	False
TACGTAGGGTGCGAGCGTTAATCGGAATTACTGGGCGTAAAGGGTGCGCAGGCGGCTTTGTAAGTCAGATGTGAAATCCCCGGGCTTAACCTGGGAATTGCGTTTGAAACTACAAGGCTAGAGTGTGGCAGAGGGAGGTGGAATTCCATG	False
TACATAGGGTGCAAGCGTTGTCCGGAATTATTGGGCGTAAAGAGCTCGTAGGTCGTTTGTCGCGTCGATTGTGAAAATCTGAGGCTCAACCTCAGACCTGCAGTCGATACGGGCAAACTAGAGTGTGGTAGGGGAGACTGGAATTCCTGG	False
TACAGAGGGTGCAAGCGTTAATCGGAATTACTGGGCGTAAAGCGCGCGTAGGTGGTTTGTTAAGTTGGATGTGAAAGCCCCGGGCTCAACCTGGGAACTGCATCCAAAACTGGCAAGCTAGAGTACAGTAGAGGGTGGTGGAATTTCCTG	False
TACGTAGGGTGCGAGCGTTGTCCGGATTTATTGGGCGTAAAGGGCTCGTAGGTGGTTGATCGCGTCGGAAGTGTAATCTTGGGGCTTAACCCTGAGCGTGCTTTCGATACGGGTTGACTTGAGGAAGGTAGGGGAGAATGGAATTCCTGG	False
TACGTAGGTGGCGAGCGTTATCCGGAATTATTGGGCGTAAAGGGTGCGTAGGCGGCACATTAAGTCTAAGGTTAAAGTTCGAGGCTCAACTTCGGATTGCCTTAGAAACTGGTGAGCTAGAGTGCAGGAGAGGGCAATGGAATTCCATGT	False
TACGTAGGGGGCAAGCGTTATCCGGATTTACTGGGTGTAAAGGGAGCGTAGGCGGTCTGGCAAGTCAGAAGTGAAAGCCCGGGGCTCAACCCCGGGACTGCTTTTGAAACTGTCGGACTAGATTGCGGGAGAGGTAAGTGGAATTCCTAG	False
TACGTAGGGGGCAAGCGTTATCCGGATTTACTGGGTGTAAAGGGAGCGTAGACGGCAGGGCAAGTCTGGAGTGAAAGGCGGGGGCTCAACCCCCGGACTGCTCTGGAAACTGCCAGGCTGGAGTGCAGGAGAGGTAAGTGGAATTCCTAG	False
TACGTAGGGAGCAAGCGTTATCCGGATTTATTGGGTGTAAAGGGTGCGTAGACGGGAATGCAAGTTAGTTGTGAAATCCCTCGGCTTAACTGAGGAACTGCAACTAAAACTACATTTCTTGAGTGCTGGAGAGGAAAGTGGAATTCCTAG	False
TACGTAGGTGGCAAGCGTTATCCGGAATGATTGGGCGTAAAGGGTGCGCAGGCGGTCCAGAAAGTCTGTAGTAAAAGGCATTGGCTCAACCAATGTATGCTGTGGAAACTGATGGACTAGAGTGCAGGAGAGGGCAGTGGAATTCCATGT	False
TACGTAGGGGGCAAGCGTTATCCGGATTTACTGGGTGTAAAGGGAGCGTAGACGGTTCTGCAAGTCTGAAGTGAAAGCCCGTGGCTTAACCGCGGAACGGCTTTGGAAACTGTGGAACTGGAGTGCTGGAGAGGCAAGCGGAATTCCTAG	False
TACGGAGGATGCGAGCGTTATCCGGATTTACTGGGTGTAAAGGGAGCGTAGACGGCGTGCCAAGTCTGATGTGAAAGCCCGGGGCCCAACCCCGGGACTGCTCTTGGAACTGCGTGGCTGGAGTGCAGGAGGGGCAGGCGGAATTCCTGG	False
TACGAAGGGTGCAAGCGTTAATCGGAATTACTGGGCGTAAAGCGCGCGTAGGTGGTTCGTTAAGTTGGATGTGAAAGCCCCGGGCTCAACCTGGGAACTGCATCCAAAACTGGCGAGCTAGAGTACGGTAGAGGGTGGTGGAATTTCCTG	False
TACGGAGGGTGCAAGCGTTATCCGGATTCACTGGGTTTAAAGGGTGCGTAGGCGGGCAGGTAAGTCAGTGGTGAAATCCTGGAGCTTAACTCCAGAACTGCCATTGATACTATCTGTCTTGAATATTGTGGAGGTAAGCGGAATATGTCA	False
TACAGAGGGTGCGAGCGTTAATCGGATTTACTGGGCGTAAAGCGTGCGTAGGCGGCTTTTTAAGTCGGATGTGAAATCCCTGAGCTTAACTTAGGAATTGCATTCGATACTGGGAAGCTAGAGTATGGGAGAGGATGGTAGAATTCCAGG	False
TACGTAGGGTGCGAGCGTTGTCCGGAATTACTGGGCGTAAAGAGCTCGTAGGCGGTTTGTCACGTCGTCTGTGAAATCCTAGGGCTTAACCCTGGACGTGCAGGCGATACGGGCTGACTTGAGTACTACAGGGGAGACTGGAATTTCTGG	False
TACGTAGGGAGCAAGCGTTATCCGGATTTATTGGGTGTAAAGGGTGCGTAGACGGGCTAACAAGTTAGTTGTGAAATCCCTCGGCTCAACTGAGGAACTGCAACTAAAACTATTAGTCTTGAGTGCGGGAGAGGAAAGTGGAATTCCTAG	False
TACGGAGGATGCGAGCGTTATCCGGATTTACTGGGTGTAAAGGGAGCGTAGGCGGCAGGGCAAGCCTGATGTGAAAGCCCGGGGCTCAACCCCGGGACTGCATTGGGAACTGCCCTGCTGGAGTGCCGGAGGGGCAGGCGGAATTCCTAG	False
TACGTAGGGGGCGAGCGTTATCCGGATTTACTGGGTGTAAAGGGAGCGCAGGCGGCGTGGCAAGTCAGATGTGAAAACCCGGGGCCCAACCCCGGGACTGCATTTGAAACTGCCATGCTGGAGTGCCGGAGAGGTAAGTGGAATTCCTAG	False
TACGAAGGGTGCAAGCGTTACTCGGAATTACTGGGCGTAAAGCGTGCGTAGGTGGTCGTTTAAGTCCGTTGTGAAAGCCCTGGGCTCAACCTGGGAACTGCAGTGGATACTGGGCGACTAGAGTGTGGTAGAGGGTAGCGGAATTCCTGG	False
TACGGAGGATGCGAGCGTTATCCGGATTTATTGGGTTTAAAGGGTGCGTAGGCGGACAGTTAAGTCAGCGGTAAAATTGCGGGGCTCAACCCCGTCGAGCCGTTGAAACTGGCAGACTTGAGTTGGCGAGAAGTACGCGGAATGCGCGGT	False
TACGTAGGGGGCAAGCGTTATCCGGATTTACTGGGTGTAAAGGGAGCGTAGGCGGCTCTGTAAGTCTGATGTGAAAATTTGGGGCTCAACCCCAAACGTGCATTGGAAACTGCAGGGCTTGAGTGCCGGAGAGGCAGGCGGAATTCCTAG	False
TACGTAGGTGGCAAGCGTTATCCGGAATGACTGGGTGTAAAGGGAGCGTAGACGGTTGTACAAGTCTGATGTGAAAGCCCACGGCTTAACCGTGGAGGGTCATTGGAAACTGGTTGACTTGAGTGCAGAAGAGGGAAGTGGAATTCCATG	False
TACGGAGGGTGCGAGCGTTAATCGGAATTACTGGGCGTAAAGCGCGCGTAGGCGGTTGACTAAGTCTGCTGTGAAAGCCCCGGGCTTAACCTGGGAACTGCAGTGGATACTGGTTGGCTAGAGTATGGTAGAGGGTAGTGGAATTTCCGG	False
TACGTAGGGTGCAAGCGTTAATCGGAATTACTGGGCGTAAAGCGTGCGCAGGCGGTGATGTAAGACAGAGGTGAAATCCCCGGGCTCAACCTGGGAACTGCCTTTGTGACTGCATCGCTGGAGTGCGGCAGAGGGGGATGGAATTCCGCG	False
TACAGAGGGTGCAAGCGTTAATCGGAATTACTGGGCGTAAAGCGCGCGTAGGTGGTTATTTAAGTCAGATGTGAAAGCCCCGGGCTTAACCTGGGAACTGCATCTGATACTGGATAACTAGAGTAGGTGAGAGGGGAGTAGAATTCCAGG	False
TACGAAGGGTGCAAGCGTTAATCGGAATTACTGGGCGTAAAGCGCGCGTAGGTGGTTTGTTAAGTTGGAAGTGAAAGCCCCGGGCTCAACCTGGGAACTGCTTTCAAAACTGGCAAGCTAGAGTATGGCAGAGGGTGGTGGAATTTCCTG	False
TACGTAGGGTGCAAGCGTTAATCGGAATTACTGGGCGTAAAGCGTGCGCAGGCGGTCTTGTAAGACAGGTGTGAAATCCCCGGGCTTAACCTGGGAACTGCACTTGTGACTGCAAGGCTGGAGTACGGCAGAGGGGGATGGAATTCCGCG	False
TACGTAGGGGGCAAGCGTTGTCCGGAATTATTGGGCGTAAAGCGCGCGCAGGCGGTCGGGTAAGTCTGATGTTAAAGCCCGGGGCTCAACCCCGGTTCGCATTGGAAACTGCTCGACTTGAGTGCAGAAGAGGAAAGCGGAATTCCACGT	False
TACGTAGGTGGCAAGCGTTATCCGGAATTATTGGGCGTAAAGCGCGCGTAGGCGGTTTCTTAAGTCTGATGTGAAAGCCCACGGCTCAACCGTGGAGGGTCATTGGAAACTGGGAAACTTGAGTGCAGAAGAGGAAAGTGGGATTCCATG	False
TACGTAGGGGGCAAGCGTTATCCGGATTTACTGGGTGTAAAGGGAGCGTAGACGGCTGTGCAAGTCTGGAGTGAAAGGCACGGGCTCAACCCGTGGACTGCTTTGGAAACTGTGCGGCTTGAGTGTCGGAGAGGCAGGCGGAATTCCTAG	False
TACGTAGGTCCCGAGCGTTGTCCGGATTTATTGGGCGTAAAGCGAGCGCAGGCGGTTAGATAAGTCTGAAGTTAAAGGCTGTGGCTTAACCATAGTACGCTTTGGAAACTGTTTAACTTGAGTGCAAGAGGGGAGAGTGGAATTCCATGT	False
TACGTAGGGAGCAAGCGTTGTCCGGATTTACTGGGTGTAAAGGGTGCGTAGGCGGCTTTGCAAGTCAGAAGTGAAATCTATGGGCTTAACCCATAAACTGCTTTTGAAACTGTTGAACTAGATTGCAGGAGAGGTAAGTGGAATTCCTAG	False
TACGTAGGTGGCGAGCGTTATCCGGAATTATTGGGCGTAAAGGGTGCGCAGGCGGTCCTGCAAGTCTGGAGTGAAACGCATGAGCTCAACTCATGCATGGCTTTGGAAACTGGAGGACTGGAGAGCAGGAGAGGGCGGTGGAACTCCATG	False
TACAGAGGGTGCAAGCGCTAATCGGAATTACTGGGCGTAAAGCGAGCGTAGGTGGCTTGATAAGTCAGATGTGAAATCCCCGGGCTTAACCTGGGAACTGCATCTGATACTGTTAGGCTAGAGTAGGTGAGAGGGAGGTAGAATTTCAGG	False
TACAGAGGGTGCAAGCGTTAATCGGAATTACTGGGCGTAAAGCGAGCGTAGGTGGCTTGATAAGTCAGATGTGAAATCCCCGGGCTTAACCTGGGAACTGCATCTGATACTGTTGGGCTAGAGTAGGTGAGAGGGAGGTAGAATTTCAGG	False
TACGTAGGGTGCAAGCGTTAATCGGAATTACTGGGCGTAAAGCGTGCGCAGGCGGTTCGGAAAGAAAGATGTGAAATCCCAGAGCTTAACTTTGGAACTGCATTTTTAACTACCGGGCTAGAGTGTGTCAGAGGGAGGTGGAATTCCGCG	False
TACGTAGGTGGCGAGCGTTATCCGGAATGATTGGGCGTAAAGGGTGCGCAGGCGGTCCTGCAAGTCTGGAGTGAAACGTATGAGCTCAACTCATGCATGGCTCTGGAAACTGGAGGACTGGAGAGCAGGAGAGGGCGGTGGACCTCCATG	False
TACGTAGGGTGCGAGCGTTAATCGGAATTACTGGGCGTAAAGCGTGCGCAGGCGGCGACATAAGACAGATGTGAAATCCCCGGGCTCAACCTGGGAACTGCGTTTGTGACTGTGTTGCTAGAGTGTAGCAGAGGGGGGTGGAATTCCACG	False
TACGTAGGGTGCAAGCGTTAATCGGAATTACTGGGCGTAAAGCGTGCGCAGGCGGTTTTGTAAGACAGGCGTGAAATCCCCGGGCTCAACCTGGGAATTGCGCTTGTGACTGCAAGGCTGGAGTGCGGCAGAGGGGGATGGAATTCCGCG	False
TACGTAGGGGGCAAGCGTTGTCCGGAATCATTGGGCGTAAAGCGCGTGTAGGCGGCCACGTTAGTCCGTTCTGAAAGCCCGGGGCTCAACCCCGGGAGGCGGATGGATACTGCGTGGCTCGAGTCCGGAAGAGGCGAGTGGAATTCCTGG	False
TACGTAGGGTGCGAGCGTTAATCGGAATTACTGGGCGTAAAGCGTGCGCAGGCGGTGCTGTAAGACAGGCGTGAAATCCCCGGGCTTAACCTGGGAATGGCGCTTGTGACTGCAGTGCTGGAGTGCGGCAGAGGGGGATGGAATTCCGCG	False
TACGAAGGGTGCAAGCGTTAATCGGAATTACTGGGCGTAAAGCGTGCGTAGGCGGTTTGTTAAGTCAGATGTGAAAGCCCCGGGCTCAACCTGGGAACTGCATTTGATACTGGCAGGCTAGAGTACGGTAGAGGGTGGTGGAATTCCCGG	False
TACGGAGGATCCAAGCGTTATCCGGATTTATTGGGTTTAAAGGGTGCGTAGGCGGACCCTTAAGTCAGTGGTGAAAGTTTGCAGCTCAACTGTAAAATTGCCATTGAAACTGAGGGTCTTGAGTGTAAATGAGGTAGGCGGAATGTGTTG	False
TACGTAGGTGACAAGCGTTGTCCGGATTTATTGGGCGTAAAGGGAGCGCAGGCGGTCTGTTTAGTCTAATGTGAAAGCCCACGGCTTAACCGTGGAACGGCATTGGAAACTGACAGACTTGAATGTAGAAGAGGAAAATGGAATTCCAAG	False
AACGTAGGGGGCGAGCGTTGTCCGGAATTACTGGGCGTAAAGCGCGCGCAGGCGGTCCTTTAAGTCTGATGTGAAATTCCGCGGCTCAACCGCGGGTGTGCATTGGAAACTGGGGGACTTGAGTGCGGAAGAGGGGAGCGGAATTCCCGG	False
TACAGAGGGTGCGAGCGTTGTCCGGAATCACTGGGCGTAAAGGGCGCGTAGGCGGTCGGGCACGCGTGCGGTGAAAGCCCGGGGCTCAACCCCGGGTCGGCCGTGCGAACGGCGCGACTGGAGCGCACCAGAGGCAGGCGGAATTCCGGG	False
TACGAAGGGGGCTAGCGTTGCTCGGAATTACTGGGCGTAAAGGGCGCGTAGGCGGACAGTTTAGTCAGAGGTGAAAGCCCAGGGCTTAACCTTGGAATAGCCTTTGATACTGACTGTCTTGAGTACGGGAGAGGTGTGTGGAACTCCGAG	False
TACGTAGGTCCCGAGCGTTATCCGGATTTATTGGGCGTAAAGCGAGCGCAGGCGGTTAGATAAGTCTGAAGTTAAAGGCTGTGGCTTAACCATAGTACGCTTTGGAAACTGTTTAACTTGAGTGCAGAAGGGGAGAGTGGAATTCCATGT	False
GACAGAGGGTGCAAACGTTGTTCGGAATTACTGGGCGTAAAGCGCGTGTAGGCGGCTTGGCAAGTCGGGTGTGAAAGCCCTGGGCTCAACCTAGGAAGTGCACTCGAAACTGCCTCGCTAGAGTGTCGGAGAGGGTAGTGGAATTCTCGG	False
TACGTAGGGGGCGAGCGTTGTCCGGAATGATTGGGCGTAAAGCGCGCGCAGGCGGTCCTTTAAGTCTGATGTAAAAGCCCGCGGCTTAACCGCGGAAGGTCATTGGAAACTGGGGGACTTGAGGCTAGGAGAGGGAAGTGGAATTCCTGG	False
TACGTAGGTGGCAAGCGTTGTCCGGATTTATTGGGCGTAAAGCGCGCGCAGGCGGTCCTTTAAGTCTGATGTGAAATCTTGCGGCTCAACCGCAAGCGGTCATTGGAAACTGGGGGACTTGAGTGCAGAAGAGGAAAGCGGAATTCCACG	False
TACGTAGGGTGCGAGCGTTGTCCGGAATTACTGGGCGTAAAGGGCTCGTAGGTGGTTTGTCGCGTCGTCTGTGAAATTCTGGGGCTTAACTCCGGGCGTGCAGGCGATACGGGCATAACTTGAGTGCTGTAGGGGTAACTGGAATTCCTG	False
TACGTAGGGTGCGAGCGTTAATCGGAATTACTGGGCGTAAAGCGTGCGCAGGCGGCTTTGCAAGACAGAGGTGAAATCCCCGGGCTCAACCTGGGAACTGCCTTTGTGACTGCAAGGCTAGAGTACGGCAGAGGGGGATGGAATTCCGCG	False
TACGGAGGGTGCAAGCGTTAATCGGAATTACTGGGCGTAAAGCGCGCGTAGGCTGCTTGTTAAGTCGGATGTGAAATCCCCGGGCTCAACCTGGGAACTGCATTCGATACTGGCTGGCTAGAGTGTGGTAGAGGGAAGTGGAATTCCAGG	False
TACGTAGGGGGCGAGCGTTATCCGGAATTATTGGGCGTAAAGAGTGCGTAGGTGGCCATGTAAGCGCGGGGTGAAAGGCAATAGCTTAACTATTGTAAGCCTTGCGAACTGTGTGGCTTGAGTGCAGGAGAGGAAAGTGGAATTCCTAGT	False
TACGTAGGGGGCTAGCGTTGTCCGGAATCACTGGGCGTAAAGGGTTCGCAGGCGGAAATGCAAGTCAGATGTAAAAGGCAGTAGCTTAACTACTGTAAGCATTTGAAACTGCATATCTTGAGAAGAGTAGAGGTAAGTGGAATTTTTAGT	False
TACGGAGGGTGCAAGCGTTAATCGGAATTACTGGGCGTAAAGCGCGCGTAGGCGGCTTGTTAAGTCGGATGTGAAATCCCCGGGCTCAACCTGGGAACTGCATTCGATACTGGCTGGCTAGAGTGTGGTAGAGGGAAGTGGAATTCCAGG	False
TACGTAGGGTGCAAGCGTTGTCCGGATTTATTGGGCGTAAAGAGCTCGTAGGCGGTTTGTTACGTCGGATGTGAAATCCTGGAGCTTAACTCCGGGCCTGCATTCGATACGGGCAGACTCGAGTGTTGTAGGGGAGACTGGAACTCCTGG	False
TACGTAGGGTGCGAGCGTTAATCGGAATTACTGGGCGTAAAGCGTGCGCAGGCGGTTGTGCAAGACAGATGTGAAATCCCCGGGCTTAACCTGGGAACTGCATTTGTGACTGCACGGCTAGAGTGCGGCAGAGGGGAGTGGAATTCCGCG	False
TACGTAGGTGGCAAGCGTTGTCCGGATTTATTGGGCGTAAAGCGAGCGCAGGCGGTTTTTTAAGTCTGATGTGAAAGCCTTCGGCTCAACCGAAGAAGTGCATCGGAAACTGGGAAACTTGAGTGCAGAAGAGGACAGTGGAACTCCATG	False
GACGGGGGGGGCAAGTGTTCTTCGGAATGACTGGGCGTAAAGGGCACGTAGGCGGTGAATCGGGTTGAAAGTGAAAGTCGCCAAAAACTGGCGGAATGCTCTCGAAACCAATTCACTTGAGTGAGACAGAGGAGAGTGGAATTTCGTGTG	False
TACGAACTGTGCAAACGTTATTCGGAATCACTGGGCTTACAGGGTGCGTAGGCGGCATTTTAAGTCAGGTGTGAAATCCCCCGGCTCAACCGGGGAACTGCGCCTGAGACTGGATTGCTCGAGTGAGGCAGGGGTGTACGGAACTTCCGG	False
TACGTAGGGTGCGAGCGTTAATCGGAATTACTGGGCGTAAAGCGTGCGCAGGCGGTTTTGTAAGACAGAGGTGAAATCCCCGGGCTCAACCTGGGAACTGCCTTTGTGACTGCAAGGCTGGAGTACGGCAGAGGGGGATGGAATTCCGCG	False
TACAGAGGGTGCAAGCGTTAATCGGAATTACTGGGCGTAAAGCGCGCGTAGGTGGTTAGTTAAGTTGGATGTGAAATCCCCGGGCTCAACCTGGGAACTGCATTCAAAACTGACTGACTAGAGTATGGTAGAGGGTGGTGGAATTTCCTG	False
TACGAAGGGGGCTAGCGTTGCTCGGAATTACTGGGCGTAAAGCGCACGTAGGCGGACCGATAAGTCGGGGGTGAAATCCTGGAGCTCAACTCCAGAACTGCCTCCGAAACTGCCGGCCTTGAGTTCGGGAGAGGTGAGTGGAACTGCGAG	False
TACGAAGGGGGCTAGCGTTGTTCGGATTTACTGGGCGTAAAGCGCACGTAGGCGGGTCGTTAAGTCGGGGGTGAAATCCTGGAGCTCAACTCCAGAACTGCCTTCGATACTGGCGACCTAGAGTCCGGAAGAGGTGAGTGGAACTCCTAG	False
TACGTAGGGGGCAAGCGTTATCCGGAATCATTGGGCGTAAAGCGCGTGTAGGCGGTTCAGTAAGTCCGCTCTGAAAGCCCAAGGCTCAACCTTGGGAGGCGGGTGGATACTGTTGGACTAGAGTCCGGAAGAGGAGATTGGAATTCCTGG	False
GACGAACCGAGCGAACGTTGTTCGGAATCACTGGGCTTAAAGGGCGCGTAGGCGGGCTGTCAAGTCTGGGGTGAAATCCCGCGGCTCAACCGTGGAACTGCCTCAGATACTGACGGCCTCGAGGGAGATAGGGGCGAGCGGAACTAATGG	False
TACGTAGGTGGCAAGCGTTGTCCGGAATTATTGGGCGTAAAGCGCGCGCAGGCGGTTTCTTAAGTCTGATGTGAAAGCCCCCGGCTCAACCGGGGAGGGTCATTGGAAACTGGGGAACTTGAGTGCAGAAGAGGAGAGTGGAATTCCACG	False
TACGTAGGGTGCGAGCGTTGTCCGGAATTACTGGGCGTAAAGAGCTCGTAGGTGGTTTGTCGCGTTGTTCGTGAAATCTCACGGCTTAACTGTGAGCGTGCGGGCGATACGGGCAGACTTGAGTACTGCAGGGGAGACTGGAATTCCTGG	False
TACGAATTGTGCAAACGTTATTCGGAATCACTGGGCTTAAAGGGTGCGTAGGCGGCCATGAAGGTCTGATGTGAAATCCCACGGCTCAACCGTGGAATTGCGTTGGAAACCACATGGCTTGAGGAAGACAGAGGTGAGCGGAACTAATGG	False
TACGTAGGGGGCAAGCGTTATCCGGAATCATAGGGCGTAAAGCGCGTGTAGGCGGTTCAGTAAGTCCGCTCTGAAAGCCCAAGGCTCAACCTTGGGAGGCGGGTGGATACTGTTGGACTAGAGTCCGGAAGAGGAGATTGGAATTCCTGG	False
TACGGAGGGTGCAAGCGTTAATCGGAATTACTGGGCGTAAAGGGTGCGTAGGTGGTTGTGTAAGTTATCTGTGAAATCCCCGGGCTCAACCTGGGCAGGTCAGATAATACTGCATAACTCGAGTGTGGGAGAGGGTAGTGGAATTTCCGG	False
TACGTAAGGACCGAGCGTTGTCCGGAATCATTGGGCGTAAAGGGTACGTAGGCGGGTCATTAAGTTAGAAGTCAAAGGCTATAGCTCAACTATAGTAAGCTTCTAAAACTGGAGACCTTGAGTAATGGAAGGGAAAGTGGAATTCCTAGT	False
TACGAAGGGGGCTAGCGTTGTTCGGAATTACTGGGCGTAAAGCGCACGTAGGCGGATATGTAAGTCAGGGGTGAAATCCCGGGGCTCAACCTCGGAACTGCCTTTGATACTGCAAGTCTTGAGTCCGGAAGAGGTGAGTGGAATTCCTAG	False
TACGGAAGGTTCGGGCGTTATCCGGATTTATTGGGTTTAAAGGGAGCGTAGGCCGTTTGGTAAGCGTGTTGTGAAATGTAGGAGCTCAACTTCTAGATTGCAGCGCGAACTGTCAGACTTGAGTGCGCACAACGTAGGCGGAATTCATGG	False
TACGTAGGTGGCAAGCGTTGTCCGGAATTATTGGGCGTAAAGCGCGCGCAGGTGGTTCCTTAAGTCTGATGTGAAAGCCCCCGGCTCAACCGGGGAGGGTCATTGGAAACTGGGGAACTTGAGTGCAGAAGAGGATAGTGGAATTCCAAG	False
TACGTAGGGGGCGAGCGTTGTCCGGAATTATTGGGCGTAAAGCGCGCGCAGGCGGTCTCTTAAGTCTGATGTGAAAGCCCACGGCTCAACCGTGGAGGGTCATTGGAAACTGGGGGACTTGAGGGCAGGAGAGGAGAGCGGAATTCCACG	False
AACGTAGGAGGCGAGCGTTATCCGGATTTACTGGGTGTAAAGCGCGTGCAGGCGGTAAGCTAAGTTGGGTGTGAAAGCTCCTGGCTCAACTGGGAGAGGTCGCTCAAGACTGGCTAACTCGAGGATGGTAGGGGAAGGTGGAATTCCGGG	False
TACATAGGGTGCAAGCGTTAATCAGAATTACTGGGCGTAAAACGTGCGCAAGCGGTTTTGTAAGACAGGCGTGAAATCCCCGGGCTCAACCTGGGAATTACACTTATGACTGCAAGACTGGAGTGCGGCAGAGGGGGATGGAATTCCGCG	False
TACGAAGGGGGCTAGCGTTGTTCGGAATTACTGGGCGTAAAGCGCACGTAGGCGGATTGTTAAGTGAGGGGTGAAATCCCGGGGCTCAACCCCGGAACTGCCTTTCATACTGGCAATCTTGAGTCCGAGAGAGGTGAGTGGAATTCCGAG	False
TACGGAGGGGGCTAGCGTTGTTCGGAATTACTGGGCGTAAAGCGCACGTAGGCGGCGATTTAAGTCAGGGGTGAAAGCCCAGTGCTCAACACTGGAACTGCCCTTGAGACTGGATTGCTTGAATCCGGGAGAGGTGAGTGGAATTCCGAG	False
TACGGAGGGTGCAAGCGTTATCCGGATTCATTGGGTTTAAAGGGTCCGCAGGCGGGCTTGTAAGTCAGGGGTGAAAGCCGACAGCTTAACTGTCGAACTGCCTTTGATACTGCAAGTCTTGAGTGAGGTTGAAGTAGCTGGAATGTGTAG	False
TACGGAGGGTGCAAGCGTTAATCGGAATTACTGGGCGTAAAGCGCACGTAGGTGGTTTATTAAGTCAGATGTGAAATCCCTGGGCTCAACCTAGGCAGGTCATCTGATACTGGTAGACTAGAATGTGGGAGAGGGAAGTGGAATTTCCGG	False
TACAGAGGGTGCGAGCGTTAATCGGAATTACTGGGCGTAAAGCGCGCGTAGGCGGCTTTGCAAGTCGGGTGTGAAATCCCCAGGCTTAACCTGGGAACTGCACTCGAGACTGCATTGCTAGAGTATCGGAGAGGGAAGTGGAATTTCCGG	False
TACGAAGGGTGCAAGCGTTAATCGGAATTACTGGGCGTAAAGCGCGCGTAGGTGGTTCAGTAAGTTGGAAGTGAAATCCCCGGGCTCAACCTGGGAACTGCTTTCAAAACTGCTGAGCTAGAGTACGGTAGAGGGTGGTGGAATTTCCTG	False
GACGAACCGAGCGAACGTTGTTCGGAATCACTGGGCTTAAAGGGCGCGTAGGCGGGCTGTCAAGTCTGGGGTGAAATCCCGCGGCTCAACCGTGGAACTGCCTCAGATACTGACGGCCTCGAGGGAGATAGGGGCGAGCGGACCTAATGG	False
TACGGAGGGTGCAAGCGTTATCCGGATTTATTGGGTTTAAAGGGTCCGTAGGCGGGTTAATAAGTCAGTGGTGAAAGCCCGCAGCTTAACTGTGGAACTGCCATTGATACTGTTAGTCTTGAGTGTAGTTGAAGTGGCTGGAATGAGTAG	False
TACGTAGGTGGCAAGCGTTGTCCGGAATTACTGGGTGTAAAGGGCGTGTAGGCGGGGAGGTAAGTCAGATGTGAAATTCCAGGGCTCAACCCTGGAGCTGCATCTGAAACTATCTTTCTTGAGTGCTGGAGAGGAAAGCGGAATTCCTAG	False
TACGTAGGGTGCAAGCGTTAATCGGAATTACTGGGCGTAAAGCGTGCGCAGGCGGTTATGTAAGACAGTTGTGAAATCCCCGGGCTCAACCTGGGAACTGCATCTGTGACTGCATAGCTAGAGTACGGTAGAGGGGGATGGAATTCCGCG	False
TACATAGGGTGCAAGCGTTGTCCGGAATTATTGGGCGTAAAGAGCTCGTAGGTCGTTAATCACGTCGGATGTGAAAATCTGAGGCTCAACCTCAGACCTGCATTCGATACGGGTTAACTAGAGTGTGGTAGGGGAGACTGGAATTCCTGG	False
TACGGAGGGGGCTAGCGTTGTTCGGAATTACTGGGCGTAAAGCGCACGTAGGCGGACCGGAAAGTCAGAGGTGAAATCCCAGGGCTCAACCTTGGAACTGCCTTTGAAACTATCGGTCTGGAGTTCGAGAGAGGTGAGTGGAATTCCGAG	False
TACGGAGGGTGCGAGCGTTAATCGGAATTACTGGGCGTAAAGCGCGCGTAGGCGGTTTGCTAAGTCCGCTGTGAAAGCCCCGGGCTTAACCTGGGAACTGCAGTGGATACTGGCAGGCTAGAGTATGGTAGAGGATAGTGGAATTTCCGG	False
TACGTAGGTGGCAAGCGTTATCCGGAATGATTGGGCGTAAAGGGTGCGCAGGCGGTCCTGCAAGTCTGGAGTGAAACGCATGAGCTCAACTCATGCATGGCTTTGGAAACTGGAGGACTGGAGAGCAGGAGAGGGCGGTGGAACTCCATG	False
TACGTAGGGCGCGAGCGTTGTCCGGAATTACTGGGTGTAAAGGGAGCGTAGGCGGGCGAGAAAGTTGAATGTTAAATCTACCGGCTTAACTGGTAGCTGCGTTCAAAACTTCTTGTCTTGAGTGAAGTAGAGGCAGGCGGAATTCCTAGT	False
TACGGAGGGTGCAAGCGTTAATCGGAATTACTGGGCGTAAAGCGCGCGTAGGCGGTTCACTCAGTCTGCTGTGAAAGCCCCGGGCTTAACCTGGGAACGGCAGTGGATACTGGTGGGCTAGAGTATGGTAGAGGGGAGTGGAATTTCCGG	False
TACGTAGGGGGCAAGCGTTATCCGGATTTACTGGGTGTAAAGGGAGCGCAGGCGGTACGGCAAGTCTGATGTGAAAGCCCGGGGCCCAACCCCGGGACTGCCCTTGGAACTGCATGGCTGGAGTGCGGGAGGGGCAGGCGGAATTCCTGG	False
TACGTAGGGGGCAAGCGTTATCCGGAATTACTGGGTGTAAAGGGAGAGTAGGCGGCAAGGTAAGCGATATGTGAAAGCCTTAGGCTTAACCAAAGGATTGCATAACGAACTATCTAGCTAGAGTACAGGAGAGGAAAGCGGAATTCCTAA	False
TACGTAGGGGGCAAGCGTTATCCGGATTTACTGGGTGTAAAGGGAGCGTAGACGGCGGAACAAGTCAGAAGTGAAAACCCGGGGCTCAACCCTGGGAGTGCTTTTGAAACTGTTTGGCTGGAGTGCAGGAGAGGTAAGCGGAATTCCTAG	False
TACGTAGGGGGCGAGCGTTATCCGGATTCATTGGGCGTAAAGCGCGCGTAGGCGGCCAGTTAGGTCGGGAGTCAAATTTCGGGGCTCAACCCCGTCTCGCTCCCGATACCGGCTGGCTGACTATCTCGTATGCCGTCTTCTGCTTGAAAA	False
TACGTAGGGGGCGAGCGTTATCCGGATTCACTGGGTGTAAAGGGGGCGCAGACGGCGATGCAAGCCAGGAGTGAAAGCCCGGGGCCCAACCCCGGGACTGCTCTGGAAACTGTGCGGCTAGAGTACTGGAGAGGCAGACGGAATTCCTAG	False
TACGTAGGGAGCGAGCGTTATCCGGAATTATTGGGTGTAAAGGGTGCGTAGACGGGAATGCAAGTTAGTTGTGAAATCCCTCGGCTTAACTGAGGAACTGCAACTAAAACTACATTTCTTGAGTGCAGGAGAGGTAAGTGGAATTCCTAG	False
TACGTAGGGGGCGAGCGTTATCCGGATTCATTGGGCGTAAAGCGCGCGTAGGCGGCCGCCTAAGCGGAACCTCTAATCCCGGGGCTCAACCTCGGGCCGGGTTCCGGACTGGGCGGCTCGAGTGCGGTACAGGCAGTTGGAATTCCCGGT	False
TACGTAGGGGGCGAGCGTTATCCGGATTCACTGGGTGTAAAGGGAGCGTAGACGGCTGTGCAAGCCAGGAGTGAAAGCCCGGGGCCCAACCCCGGGACTGCTCTTGGAACTGTAAAGCTAGAGTGCGGGAGGGGCAGGCGGAATTCCTGG	True
TACGTAGGGTGCAAGCGTTGTCCGGAATTACTGGGCGTAAAGAGCTCGTAGGTGGTTTGTCGCGTCGTCTGTGAAATCCCGGGGCTTAACTTCGGGCGTGCAGGCGATACGGGCATAACTTGAGTGCTGTAGGGGAGACTGGAATTCCTG	False
TACGTAGGGAGCAAGCGTTGTCCGGAATTACTGGGTGTAAAGGGAGCGTAGGCGGGATAGTAAGTTGATTGTTAAAACTATCGGCTCAACTGGTAGATGCGATCAAAACTGCAATTCTTGAGTGAAGTAGAGGCAGGCGGAATTCCTAGT	False
TACGGAGGGAGCTAGCGTTGTTCGGAATTACTGGGCGTAAAGCGCACGTAGGCGGCTTTGTAAGTCAGAGGTGAAAGCCTGGAGCTCAACTCCAGAACTGCCTTTGAGACTGCATCGCTTGAATCCAGGAGAGGTGAGTGGAATTCCGAG	False
TACGTAGGGGGCAAGCGTTATCCGGATTTACTGGGTGTAAAGGGGGCGCAGACGGCGATGCAAGCCAGGAGTGAAAGCCCGGGGCCCAACCCCGGGACTGCTCTTGGAACTGCGTGGCTGGAGTGCAGGAGGGGCAGGCGGACTTCCTGG	False
TACGTAGGTGGCAAGCGTTGTCCGGATTTACTGGGTGTAAAGGGCGTGTAGCCGGGCTGACAAGTCAGATGTGAAATTCCGGGGCTCAACCCCGGATCTGCATTTGAAACTGTTGGTCTTGAGTATCGGAGAGGCAGGCGGAATTCCTAG	False
TACGTAGGTGGCAAGCGTTATCCGGAATTATTGGGCGTAAAGCGCGCGTAGGCGGTTTCTTAAGTCTGATGTGAAAGCCCACGGCTCAACCGTGGAGGGTCATTGGAAACTGGGGAACTTGAGTGCAGAAGAGGAGAGTGGAATTCCATG	False
TACGGAGGGTGCGAGCGTTAATCGGAATTACTGGGCGTAAAGCGCGCGTAGGCGGCGTGATAAGCCGGTTGTGAAAGCCCCGGGCTCAACCTGGGAACGGCATCCGGAACTGTCAGGCTAGAGTGCAGGAGAGGAAGGTAGAATTCCCGG	False
TACGTAGGGGGCGAGCGTTATCCGGATTTATTGGGCGTAAAGCGTGTGTAGGCGGTTTATTAAGTCTAAGATCAAAGCCCGAGGCTCAACCTCGGTTCGTCTTAGAAACTGGTAGACTTGAGTGTGGTAGAGGCAAGTGGAATTTCTAGT	False
TACGTAGGGGGCAAGCGTTATCCGGATTTACTGGGTGTAAAGGGCGTGCAGCCGGAGAGACAAGTCAGATGTGAAATCCACGGGCTCAACCCGTGAACTGCATTTGAAACTGTTGGTCTTGAGTATCGGAGAGGCAGGCGGAATTCCTAG	False
TACGTAGGTGGCAAGCGTTGTCCGGAATTATTGGGCGTAAAGCGCGCGCAGGCGGATCTGCCAGTCTGTCTTAAAAGTTCGGGGCTCAACCCCGTGATGGGATGGAAACTACAGATCTAGAGTATCGGAGGGGAAAGTGGAATTCCTAGT	False
TACGGAGGGTCTAAGCGTTATCCGGATTTATTGGGTTTAAAGGGTGCGTAGGCGGTTCGGTAAGTTAGAGGTGAAATCCCGGGGCTCAACCCTGGAACTGCCTCTGATACTGCCGGGCTAGAGAATGGTTGCTGTGGGCGGAATGTATGG	False
TACGGAGGGGGCTAGCGTTGTTCGGAATTACTGGGCGTAAAGCGCACGTAGGCGGACTGGAAAGTTGGGGGTGAAATCCCGGGGCTCAACCTCGGAACTGCCTTCAAAACTATCAGTCTGGAGTTCGAGAGAGGTGAGTGGAATTCCGAG	False
TACGTAGGGGGCGAGCGTTGTCCGGAATTACTGGGCGTAAAGAGTTCGTAGGCGGTCTGATAAGTCAGATGTGAAAGGCGTAGGCTTAACCTATGTAAGCATATGAAACTGTCAGACTTGAGGTAAGGAGAGGAAAGTGGAATTCCTAGT	False
TACGGAGGATCCAAGCGTTATCCGGAATCATTGGGTTTAAAGGGTCCGTAGGCGGTCTTATAAGTCAGTGGTGAAATCTCCTAGCTCAACTAGGAAACTGCCATTGATACTGTAAGACTTGAATTTTTGTGAAGTAACTAGAATATGTAG	False
TACGTAGGTGGCGAGCGTTATCCGGAATTATTGGGCGTAAAGGGTGCGTAGGCGGTTCATTAAGTCTGTGGTTAAAGTGCGGGGCTCAACCCCGTATAGCCATGGAAACTGGTGAACTAGAGTGCAGGAGAGGGCAGTGGAATTCCATGT	False
TACGTAGGGTGCGAGCGTTAATCGGAATTACTGGGCGTAAAGCGTGCGCAGGCGGTTATGTAAGACAGGCGTGAAATCCCCGAGCTTAACTTGGGAATTGCGCTTGTGACTGCATAGCTAGAGTGTGTCAGAGGGGGGTAGAATTCCACG	False
TACGTAGGGAGCGAGCGTTGTCCGGATTTACTGGGTGTAAAGGGCGTGTAGGCGGAGCTGCAAGTCAGAAGTGAAATCCCCGGGCTCAACCCGGGAACTGCTTTTGAAACTGTAGCCCTTGAGTATCGGAGAGGCAGGCGGAATTCCTAG	False
TACGTAGGGTGCGAGCGTTAATCGGAATTACTGGGCGTAAAGCGTGCGCAGGCGGATTGTTAAGCAAGATGTGAAATCCCCGGGCTTAACCTGGGAATGGCATTTTGAACTGGCAGTCTAGAGTGTGTCAGAGGGGGGTGGAATTCCACG	False
TACGTAGGGTGCAAGCGTTAATCGGAATTACTGGGCGTAAAGCGTGCGCAGGCGGTTTTGTAAGACAGAGGTGAAATCCCCGGGCTCAACCTGGGAACTGCCTTTGTGACTGCAAGGCTAGAGTACGGCAGAGGGGGATGGAATTCCGCG	False
TACGTAGGTGGCAAGCGTTATCCGGAATTATTGGGCGTAAAGGGTGCGTAGGCGGTTTATTAAGTCTATGGTGAAAGTGCGGGGCTCAACCCCGTATGGCCATAGAAACTGATAGACTTGAGTGCAGGAGAGGGCAATGGAATTCCATGT	False
TACAGAGGGTGCAAGCGTTAATCGGAATTACTGGGCGTAAAGCGCGCGTAGGTGGTTTGTTAAGTTGGATGTGAAATCCCCGGGCTCAACCTGGGAACTGCATTCAAAACTGACTGACTAGAGTATGGTAGAGGGTGGTGGAATTTCCTG	False
TACAGAGGTCTCAAGCGTTGTTCGGATTCATTGGGCGTAAAGGGTGCGTAGGTGGCGCGCTAAGTCAGGTGTGAAATTTCGGAGCTTAACTCCGAAACTGCATTTGATACTGGCGTGCTCGAGGACTGGAGAGGAGACTGGAATTCACGG	False
TACGTAGGTGGCAAGCGTTGTCCGGAATTATTGGGCGTAAAGCGCTCGCAGGCGGTTCCTTAAGTCTGATGTGAAATCTTGCAGCTTAACTGCAAACGGTCATTGGAAACTGGGGGACTTGAGTACAGAAGAGGAGAGCGGAATTCCACG	False
GACAGAGGATGCAAGCGTTATCCGGAATGATTGGGCGTAAAGCGTCTGTAGGTGGCTTTTCAAGTCCGCCGTCAAATCCCAGGGCTCAACCCTGGACAGGCGGTGGAAACTACCAAGCTGGAGTACGGTAGGGGCAGAGGGAATTTCCGG	False
TACGTAGGGTGCGAGCGTTAATCGGAATTACTGGGCGTAAAGCGTGCGCAGGCGGTTTTGTAAGACAGACGTGAAATCCCCGGGCTCAACCTGGGAATGGCGTTTGTGACTGCAAAGCTGGAGTGCGGCAGAGGGGGATGGAATTCCGCG	False
TACGAAGGGTGCAAGCGTTACTCGGAATTACTGGGCGTAAAGCGTGCGTAGGCGGTTTGTTAAGTCAGATGTGAAAGCCCCGGGCTCAACCTGGGAATTGCATTTGAAACTGGCGAGCTAGAGTGTGGTAGAGGGTGGTGGAATTCCCGG	False
GACGGAGGAGGCTAGCGTTGTTCGGAATTACTGGGCGTAAAGCGTGCGCAGGTTGTGAGATCAGTTGGATGTGAAAGCCCGGGGCTTAACCTCGGATGTGCATCCAATACTGTCTCGCTGGAGGTTGGAAGAGGAGAGTGGAATTCCCAG	False
TACGGAGGGTGCAAGCGTTATCCGGATTCACTGGGTTTAAAGGGTGCGTAGGCGGGCAGGTAAGTCAGTGGTGAAATCCCCGAGCTTAACTCGGGAACTGCCGTTGATACTATCTGTCTTGAATACCGTGGAGGTGAGCGGAATATGTCA	False
TACGTAGGGCGCGAGCGTTGTCCGGAATTATTGGGCGTAAAGAGCTTGTAGGCGGTTGGTCGCGTCTGCTGTGAAAGGCTGGGGCTTAACCCTGGTTTTGCAGTGGGTACGGGCTAACTAGAGTGCAGTAGGGGAGACTGGAATTCCTGG	False
TACGTAGGTGGCGAGCGTTATCCGGAATGATTGGGCGTAAAGGGTGCGCAGGCGGCCGGGCAAGTCCGCAGTAAAAACTGGAGGCTCAACCTTCAGGGGCTGCGGAAACTGTCCGGCTGGAGAGCAGGAGAGGACGGTGGAACTCCATGT	False
TACGTAGGGTGCAAGCGTTAATCGGAATTACTGGGCGTAAAGCGTGCGCAGGCGGTTATATAAGACAGATGTGAAATCCCCGGGCTCAACCTGGGAACTGCATTTGTGACTGTATAGCTAGAGTACGGTAGAGGGGGATGGAATTCCGCG	False
TACGAAGGGGGCTAGCGTTGTTCGGAATTACTGGGCGTAAAGCGCACGTAGGCGGACTATTAAGTCAGGGGTGAAATCCCGGGGCTCAACCCCGGAACTGCCTTTGATACTGGTAGTCTAGAGTTCGAGAGAGGTGAGTGGAATTCCGAG	False
TACGGGGGGGGCAAGCGTTGTTCGGAATTACTGGGCGTAAAGGGCTCGTAGGTGGCCCACTAAGTCAGACGTGAAATCCCTCGGCTTAACCGGGGAATGGCGTCTGATACTGGTGGGCTTGAGTTCGGGAGAGGGATGCGGAATTCCAGG	False
TACGTAGGGTGCGAGCGTTAATCGGAATTACTGGGCGTAAAGCGTGCGCAGGCGGTTGTGCAAGACAGATGTGAAATCCCCGGGCTTAACCTGGGAACTGCATTTGTGACTGCACGGCTAGAGTGTGTCAGAGGGGGGTAGAATTCCACG	False
TACGGAGGGAGCTAGCGTTGTTCGGAATTACTGGGCGTAAAGCGCACGTAGGCGGCTTTTTAAGTCAGGGGTGAAATCCCGGGGCTCAACCCCGGAACTGCCCTTGAAACTGGAAAGCTAGAATACTGGAGAGGTGAGTGGAATTCCGAG	False
TACGTAGGTGGCAAGCGTTGTCCGGAATTATTGGGCGTAAAGGGTACGTAGGCGGCCTTTTAAGTCAGGTGTGAAAGCGTGAGGCTTAACCTCATTAAGCACTTGAAACTGGAAGGCTTGAGTGAAGGAGAGGAAAGTGGAATTCCTAGT	False
TACGGAGGGTGCGAGCGTTGTCCGGAATCACTGGGCGTAAAGGGCGCGTAGGCGGCAGGCCAAGCGTGCGGTGAAAGTCCGGGGCTCAACCCCGGATCTGCCGTGCGGACTGGTTTGCTGGAGCACTGTAGAGGCGAGTGGAATTCCGGG	False
TACGTAGGGTGCGAGCGTTAATCGGAATTACTGGGCGTAAAGCGTGCGCAGGCGGTTTTGTAAGTCAGATGTGAAATCCCCGGGCTCAACCTGGGAACTGCGTTTGAAACTACAAGGCTAGAGTGTAGCAGAGGGGGGTAGAATTCCACG	False
TACGTAGGTGGCAAGCGTTGTCCGGATTTACTGGGCGTAAAGAGCGCGCAGGCGGCCGCCTCAGTCGGGCGTGAAATCTCCTGGCTCAACCGGGAGGGGGCACCCGATACTGGGCGGCTCGAGGGGTGCAGAGGCAGGTGGAATTCCGGG	False
TACGTAGGGTGCGAGCGTTGTCCGGAATTACTGGGCGTAAAGAGCTCGTAGGTGGTTTGTCGCGTCGTCTGTGAAATTCCGGGGCTTAACTCCGGGCGTGCAGGCGATACGGGCATAACTTGAGTGCTGTAGGGGAGACTGGAATTCCTG	False
TACGTAGGGCGCAAGCGTTATCCGGAATTATTGGGCGTAAAGAGCTCGTAGGCGGTTTGTCGCGTCTGCCGTGAAAGTCCGGGGCTCAACCCCGGATCTGCGGTGGGTACGGGCAGACTAGAGTGATGTAGGGGAGACTGGAATTCCTGG	False
TACGTAGGGCGCAAGCGTTGTCGGGAATTATTGGGCGTAAAGAGCTCGTAGGCGGTTTGTCGCGTCTGCTGTGAAAGCCCGGGGCTTAACCCCGGGTGTGCAGTGGGTACGGGCAGACTAGAGTGCAGTAGGGGAGACTGGAATTCCTGG	False
TACGTAGGGCGCAAGCGTTATCCGGATTTATTGGGCGTAAAGAGCTCGTAGGCAGTTTGTCGCGTCTGCCGTGAAAGTCCGAGGCTCAACCTCGGATCTGCGGTGGGTACGGGCAGACTAGAGTGATGTAGGGGAGACTGGAATTCCTGG	False
TACGTAGGGGGCAAGCGTTGTCCGGATTTATTGGGCGTAAAGCGCGCGTAGGCGGCCCCGCAAGTCGGCCGTGAAAGCTCCAGGCTCAACTTGGAGAGGTCGGGCGAGACTGCGGGGCTCGAGGCGGGCAGAGGGCAGTGGAATTCCGGG	False
TACGGAGGGAGCTAGCGTTGTTCGGAATTACTGGGCGTAAAGCGCACGTAGGCGGCTTTTTAAGTCAGGGGTGAAATCCCGGGGCTCAACCCCAGAACTGCCCTTGAAACTGGAAAGCTAGAATACTGGAGAGGTGAGTGGAATTCCGAG	False
TACGTAGGGTGCAAGCGTTAATCGGAATTACTGGGCGTAAAGCGTGCGCAGGCGGTTATGTAAGACAGATGTGAAATCCCCGGGCTCAACCTGGGAACTGCATTTGTGACTGCATAGCTAGAGTACGGTAGAGGGGGATGGAATTCCGCG	False
TACGAAGGGGGCTAGCGTTGTTCGGAATTACTGGGCGTAAAGCGCACGTAGGCGGACTTTTAAGTCAGGTGTGAAATCCCGGGGCTCAACCTCGGAACTGCATTTGAAACTGGAAGTCTGGAGATCAGGAGAGGTTAGCGGAATACCGAG	False
TACGTAGGGTGCGAGCGTTAATCGGAATTACTGGGCGTAAAGCGTGCGCAGGCGGTTGTGTAAGACAGGTGTGAAATCCCCGGGCTTAACCTGGGAACTGCGCTTGTGACTGCACGGCTAGAGTACGGCAGAGGGGGGTGGAATTCCTGG	False
TACGTAGGGGGCAAGCGTTATCCGGATTTACTGGGTGTAAAGGGAGCGTAGACGGCGTGCCAAGTCTGATGTGAAAGCCCGGGGCCCAACCCCGGGACTGCTCTTGGAACTGCGTGGCTGGAGTGATGGAGAGGCAGGCGGAATTCCGTG	False
TACGTATGGTGCAAGCGTTATCCGGATTTACTGGGTGTAAAGGGAGCGCAGGCGGTACGGCAAGTCTGATGTGAAAGCCCGGGGCCCAACCCCGGGACTGCCCTTGGAACTGCATGGCTGGAGTGCGGGAGGGGCAGGCGGAATTCCTGG	False
TACAGAGGGTGCAAGCGTTAATCGGAATTACTGGGCGTAAAGCGCGCGTAGGTGGTTTGTTAAGTTGGATGTGAAATCCCCGGGCTCAACCTGGGAACTGCATCCAAAACTGGCAAGCTAGAGTATGGTAGAGGGTGGTGGAATTTCCTG	False
TACGTAGGGGGCAAGCGTTATCCGGATTTACTGGCTGTAAAGGGAGCGTAGACGGCTGTGCAAGTCTGAAGTGAAATGCCGGGGCCCAACCCCGGAACTGCTTTGGAAACTGTACAGCTAGAGTGCAGGAGGGGTGAGCGGAATTCCTAG	False
TACGTAGGTCCCGAGCGTTGTCCGGATTTATTGGGCGTAAAGCGAGCGCAGGCGGTTAGATAAGTCTGAAGCTAAAGGCTGTGGCTTAACCATAGTACGCTTTGGAAACTGTTTAACTTGAGTGCAAGAGGGGAGAGTGGAATTCCATGT	False
TACGTAGGGGGCAAGCGTTATCCGGATTTACTGGGTGTAAAGGGAGCGCAGACGGCAGTGCAAGTCTGGAGTGAAAGCCCGGGGCCTAACCCCGGAACTGCTCTGGAAACTGTGCGGCTAGAGTACTGGAGGGGCAGGCGGAATTCCTAG	False
TACGTAGGGGGCAAGCGTTATCCGGATTTACTGGGTGTAAAGGGCGTGTAGCCGGGCTGACAAGTCAGATGTGAAATCCGGGGGCTCAACCCCCGAACTGCATTTGAAACTGGTGGTCTTGAGTGGATGAGAAGTACGCGGAATGCGTGG	False
TACGTATGGTGCAAGCGTTATCCGGATTTACTGGGTGTAAAGGGAGCGCAGGCGGTACGGCAAGTCTGATGTGAAAGCCCGGGGCTCAACCCCGGGACTGCCCTTGGAACTGCATGGCTGGAGTGCGGGAGGGGCAGGCGGAATTCCTGG	False
TACGTAGGTGGCAAGCGTTATCCGGATTTACTGGGTGTAAAGGGCGTGTAGGCGGGGAAGCAAGTCAGATGTGAAAACCACGGGCTCAACCTGTGGCCTGCATTAGAAACCCGCGTAGTCCGGCTGGCTGACTATCTCGTATGCCGTCTT	False
TACGTAGGTGGCAAGCGTTATCCGGATTTATTGGGTGTAAAGGGCGTGTAGGCGGGAATGCAAGTCAGATATGAAAACTCAGGGCTCAACCGCGGAACTGCATTTGAAACTGTTTTCCTTGAGTACCGGAGAGGTCATCGGAATTCCTTG	False
TACGTAGGGGGCAAGCGTTATCCGGATTTACTGGGCGTGAAGGGGGCGCAGGCGGCGCGCCAAGCCCGATGTGAAAGCCCGGGGCCCAACCCCGGGACTGCTCTGGGAACTGTGCGGCTGGAGTGCGGGAGGGGCAGGCGGAATTCCTGG	False
TACGGAGGATGCGAGCGTTATCCGGATTCACTGGGTGTAAAGGGAGCGTAGACGGCCATGCAAGCCTGGAGTGAAAGCCCGGGGCCCAACCCCGGGACTGCTCTGGGAACTGTGCGGCTGGAGTGCAGGAGAGGATCGTGGAATTCCATG	False
TACGTAGGGTGCAAGCGTTAATCGGAATTACTGGGCGTAAAGCGTGCGCAGGCGGTCCGCTAAGACAGATGTGAAATCCCCGGGCTTAACCTGGGAACTGCATTTGTGACTGGCGGGCTAGAGTATGGCAGAGGGGGGTAGAATTCCACG	False
TACAGAGGGTGCAAGCGTTAATCGGAATTACTGGGCGTAAAGCGCGCGTAGGTGGTTCGTTAAGTTGGATGTGAAAGCCCCGGGCTCAACCTGGGAACTGCATCCAAAACTGGCGAGCTAGAGTATGGTAGAGGGTGGTGGAATTTCCTG	False
TACGGAGGATGCGAGCGTTATCCGGATTTATTGGGTTTAAAGGGTGCGTAGGCGGACTGTCAAGTCTGGAGTGAAACGTATGAGCTCAACTCATGCATGGCTCTGGAAACTGGAGGACTGGAGAGCAGGAGAGGGCGGTGGAACTCCATG	False
TACGTAGGGGGCAAGCGTTATCCGGATTTACTGGGTGTAAAGGGAGCGTAGACGGCAGCGCAAGTCTGGAGTGAAATGCCGGGGCCCAACCCCGGGACTGCTCTTGGAACTGCATGGCTGGAGTACAGGAGGGGCAGGCGGAATTCCTAG	False
TACAGAGGGTGCAAGCGTTAATCGGAATTACTGGGCGTAAAGCGCGCGTAGGTGGTTTGTTAAGTTGGATGTGAAAGCCCCGGGCTCAACCTGGGAACTGCATCCAAAACTGGCAAGCTAGAGTATGGTAGAGGGTGGTGGAATTTCCTG	False
TACGTAGGTGGCGAGCGTTATCCGGAATGATTGGGCGTAAAGCGAGCGCAGGCGGTTGGATAAGTCTGAAGTTAAAGGCTGTGGCTCAACCATAGTATGCTTTGGAAACTGTTCAACTTGAGTGCAGAAGGGGAGAGTGGAATTCCATGT	False
GACAGAGGATGCAAGCGTTATCCGGAATGATTGGGCGTAAAGCGTCTGTAGGTGGCTTTTTAAGTCCGCCGTCAAATCCCAGGGCTCAACCCTGGACAGGCGGTGGAAACTATCAAGCTGGAGTACGGTAGGGGCAGAGGGAATTTCCGG	False
TACGTAGGGGGCTAGCGTTATCCGGAATTACTGGGCGTAAAGGGTGCGTAGGTGGTTTCTTAAGTCAGAGGTGAAAGGCTACGGCTCAACCGTAGTAAGCCTTTGAAACAGGGAAACTTGAGTGCAGGAGAGGAGAGTGGAATTCCTAGT	False
TACGTAGGGGGCTAGCGTTATCCGGAATTACTGGGCGTAAAGGGTGCGTAGGTGGTTTCTTAAGTCAGAGGTGAAAGGCTACGGCTCGACCGCAGTAAGCCTTTGAAACTGGGAAACTTGAGTGCAGGAGAGGAGAGTGGAATTCCTAGT	False
TACGTAGGGGGCAAGCGTTATCCGGATTTACTGGGTGTAAAGGGCGTGTAGCCGGGCTGACAAGTCAGATGTGAAATTCTGGGGCTCAACCCCGGACCTGCATTTGAAACTGTGCTTCTTGAGTGCAGGAGGGGCAGGCGGAATTCCTGG	False
TACGTAGGGGGCAAGCGTTATCCGGATTTACTGGGTGTAAAGGGAGCGTAGACGGAGAGGCAAGTCTGATGTGAAAACCCGGGGCTCAACCCCGGGACTGCATTGGAAACTGTTTTTCTAGAGTGTCGGAGAGGTAAGTGGAATTCCTAG	False
TACGGAGGATGCGAGCGTTATCCGGATTTACTGGGCGTGAAGGGGGCGCAGGCGGCGCGCCAAGCCCGATGTGAAAGCCCGGGGCCCAACCCCGGGACTGCTCTTGGAACTGCGTGGCTGGAGTGCAGGAGGGGCAGGCGGAATTCCTGG	False
TACGTAGGGGGCAAGCGTTATCCGGATTTACTGGGTGTAAAGGGGGCGCAGGCGGCGCGCCAAGCCCGATGTGAAAGCCCGGGGCTCAACCCCGGGACTGCTCTGGGAACTGTGCGGCTGGAGTGCGGGAGGGGCAGGCGGAATTCCTGG	False
TACGTAGGGTGCAAGCGTTAATCGGAATTACTGGGCGTAAAGCGTGCGCAGGCGGTTATGCAAGACAGAGGTGAAATCCCCGGGCTCAACCTGGGAACTGCCTTTGTGACTGCATAGCTAGAGTACGGTAGAGGGGGATGGAATTCCGCG	False
TACGTAGGGTGCGAGCGTTGTCCGGAATTACTGGGCGTAAAGAGCTCGTAGGTGGTCTGTCGCGTCATTTGTGAAAGCCCGGGGCTTAACTCCGGGTTGGCAGGTGATACGGGCATGACTGGAGTACTGTAGGGGAGACTGGAATTCCTG	False
TACAGAGGGTGCAAGCGTTAATCGGATTTACTGGGCGTAAAGCGCGCGTAGGTGGCCAATTAAGTCAAATGTGAAATCCCCGAGCTTAACTTGGGAATTGCATTCGATACTGGTTGGCTAGAGTATGGGAGAGGATGGTAGAATTCCAGG	False
TACGTAGGGGGCTAGCGTTATCCGGATTTACTGGGCGTAAAGGGTGCGTAGGTGGTCTTTCAAGTCGGTGGTTAAAGGCTACGGCTCAACCGTAGTAAGCCTCCGAAACTGTTAGACTTGAGTGCAGGAGAGGAAAGTGGGATTCCCAGT	False
TACGTAGGGGGCAAGCGTTATCCGGATTTACTGGGTGTAAAGGGAGCGTAGACGGCAGGGCAAGTCTGATGTGAAAGGTCGGGGCCCAACCCCGGGACTGCCCTTGGAACTGCATGGCTGGAGTGCAGGAGGGGCAGGCGGAATTCCTGG	False
TACGTAGGTGACAAGCGTTGTCCGGATTTATTGGGCGTAAAGCGAGCGCAGGCGGTCTTTTAAGTCTGATGTGAAAGCCCACGGCTCAACCGTGGAGGGTCATTGGAAACTGGAAGACTTGAATACAGAAGAGGAAAGTGGAATTCCATG	False
TACGGAGGGAGCTAGCGTTGTTCGGAATTACTGGGCGTAAAGCGCGCGTAGGCGGTTTTTTAAGTCAGAGGTGAAAGCCCAGTGCTCAACACTGGAACTGCCTTTGAAACTGGAAAACTTGAATCTTGGAGAGGTCAGTGGAATTCCGAG	False
TACGAAGGGGGCTAGCGTTGTTCGGAATCACTGGGCGTAAAGCGCACGTAGGCGGACTTTTAAGTCAGAGGTGAAAGCCTGGAGCTCAACTCCAGAACTGCCTTTGATACTGGGAGTCTCGAGTTCGGAAGAGGTTGGTGGAACTGCGAG	False
TACGTAGGTGGCAAGCGTTGTCCGGATTTACTGGGCGTAAAGGGAGCGTAGGCGGACTTTTAAGTGGGATGTGAAATACTCGGGCTTAACCTGGGTGCTGCATTCCAAACTGGGAGTCTAGAGTGCAGGAGGGGAAAGTGGAATTCCTAG	False
TACAGAGGGTGCAAGCGTTGTTCGGAATTATTGGGCGTAAAGCGCGTGTAGGCGGCTTGGCAAGTCAGATGTGAAAGCCCTCGGCTTAACCGAGGAAGTGCGTCTGAAACTGCTGAGCTTGAGTGTCGGAGAGGATGGCGGAATTCCGCA	False
TACGGAGGGAGCTAGCGTTGTTCGGAATTACTGGGCGTAAAGCGCGCGTAGGCGGCTTTGTAAGTTAGAGGTGAAAGCCCGGAGCTCAACTCCGGAATTGCCTTTAAGACTGCATCGCTAGAATCCGGGAGAGGTGAGTGGAATTCCGAG	False
TACGTAGGGTGCAAGCGTTGTCCGGAATTATTGGGCGTAAAGAGCTCGTAGGCGGTTTGTCGCGTCTGCTGTGAAAACGCGAGGCTCAACCTCGCGCCTGCAGTGGGTACGGGCAAACTAGAGTGCGGTAGGGGAGATTGGAATTCCTGG	False
TACAGAGGGTGCAAGCGTTGTTCGGAATTATTGGGCGTAAAGCGCGTGTAGGCGGCTTGGCAAGTCAGATGTGAAAGCCCTCGGCTTAACCGAGGAAGTGCGTCTGAAACTGCTGAGCTTGAATGTCGGAGAGGATGGCGGAATTCCGCA	False
TACGGAGGGGGCTAGCGTTGTTCGGAATTACTGGGCGTAAAGCGCACGTAGGCGGCTTTGTAAGTTAGAGGTGAAAGCCCGGAGCTTAACTCCGGAACTGCCTTTAAGACTGCATCGCTAGAATCATGGAGAGGTCAGTGGAATTCCGAG	False
TACGAAGGGTGCAAGCGTTAATCGGAATTACTGGGCGTAAAGCGCGCGTAGGTGATTCGTTAAGTTGGATGTGAAAGCCCCGGGCTCAACCTGGGAACTGCATCCAAAACTGGCGAGCTAGAGTATGGCAGAGGGTGGTGGAATTTCCTG	False
TACGAAGGGGGCTAGCGTTGTTCGGAATTACTGGGCGTAAAGCGCACGTAGGCGGACTCTTAAGTCAGGTGTGAAATCCCGGGGCTCAACCTCGGAACTGCATTTGAAACTGGAAGTCTTGAGATCAGGAGAGGTTAGCGGAATACCGAG	False
TACGGAGGGTGCAAGCGTTAATCGGAATTACTGGGCGTAAAGGGTGTGTAGGCGGTTTGATAAGTTAAGTGTGAAATACCCGGGCTTAACCTGGGAGAGTCATTTAAGACTGTCAGACTTGAGTATAGGAGAGGGTAGTGGAATTTCCGG	False
TACGTAGGGTGCGAGCGTTGTCCGGATTTATTGGGCGTAAAGGGCTCGTAGGTGGTTGATCGCGTCGGAAGTGAAATCTTGGGGCTTAACCCTGAGCGTGCTTTCGATACGGGTTGACTTGAGGAAGGTAGGGGAGAATGGAATTCCTGG	False
TACGTAGGGGGCAAGCGTTATCCGGATTTACTGGGTGTAAAGGGAGCGTAGACGGCAGCGCAAGTCTGGAGTGAAATGCCGGGGCCCAACCCCGGAGCTGCTTTGGAAACTGTGCAGCTCGAGTGCAGGAGAGGTAAGCGGAATTCCTAG	False
TACGGAGGATGCGAGCGTTATCCGGATTTATTGGGTTTAAAGAGTGCGTAGGCGGACAGTTAAGTCAGCGGTAAAATTGAGAGGCTCAACCTCTTCCCGCCGTTGAAACTGATTGTCTTGAGTGGGCGAGAAGTATGCGGAATGCGTGGT	False
TACGTAGGGGGCAAGCGTTATCCGGATTTACTGGGTGTAAAGGGAGCGTAGACGGCAGCAAAGGTCTGTGGTGAAAGACTGAAGCTTAACTTCAGTAAGCCATAGAAACCGGGCAGCTAGAGTGCAGGAGAGGATCGTGGAATTCCATGT	False
TACGTAGGTGGCAAGCGTTGTCCGGATTTACTGGGTGTAAAGGGCGTGCAGCCGGGAGTGCAAGTCAGATGTGAAATCCCGCGGCTCAACCGCGGAACTGCATTTGAAACTGTGTTTCTTGAGTGCTGGAGAGGCAATCGGAATTCCGTG	False
TACGTAGGGGGCAAGCGTTATCCGGATTCACTGGGTGTAAAGGGAGCGTAGACGGCCATGCAAGCCTGGAGTGAAAGCCCGCGGCCCAACCGCGGGACTGCATTGGGAACTGGCGCGCTGGAGTGCCGGAGGGGTAGGCGGACTTCCTAG	False
TACGTAGGTGGCGAGCGTTATCCGGAATGATTGGGCGTAAAGGGTGCGCAGGCGGTCCTGCAAGTCTGGAGTGAAACGCATGAGCTCAACTCATGCATGGCTTTGGAAACTGTAGGACTGGAGAGCAGGAGAGGGCGGTGGAACTCCATG	False
TACGGAGGATGCGAGCGTTATCCGGATTTATTGGGTTTAAAGGGCGCGTAGGCGGACTGTCTAGTCAGCGGTAAAATTGAGAGGCTCAACCTCTTCCCGCCGTTGAAACTGGTGGTCTTGAGTGGATGAGAAGTACGCGGAATGCGTGGT	False
TACGGAGGGGGCTAGCGTTATTCGGAATTACTGGGCGTAAAGCGCACGTAGGCGGCTTTGTAAGTTAGAGGTGAAAGCCCAGAGCTCAACTCTGGAATTGCCTTTAAGACTGCATCGCTTGAATCATGGAGAGGTGAGTGGAATTCCGAG	False
TACGTAGGTGGCAAGCGTTGTCCGGATTTACTGGGTGTAAAGGGCGTGTAGCCGGGCCGGCAAGTCAGATGTGAAATCCCAAGGCTCAACCTTGGAGCTGCATTTGAAACTGTTGGTCTTGAGTATCGGAGAGGCAGGCGGAATTCCTAG	False
TACGTAGGGTGCGAGCGTTGTCCGGAATTACTGGGCGTAAAGAGCTCGTAGGTGGTTTGTCGCGTCGTTTGTGTAATACCGCAGCTTAACTGTGGGGTTGCAGGCGATACGGGCATAACTTGAGTGCTGTAGGGGAGACTGGAATTCCTG	False
TACGGAGGGTGCAAGCGTTAATCGGAATTACTGGGCGTAAAGCGCACGCAGGCGGCTTTTTAAGTCGGATGTGAAAGCCCCGGGCTCAACCTGGGAATTGCATCTGATACTGGGAAGCTAGAGTATGTGAGAGGGGGGTAGAATTCCAAG	False
TACGAAGGGGGCTAGCGTTGTTCGGAATTACTGGGCGTAAAGCGCACGTAGGCGGACATTTAAGTCAGGGGTGAAATCCCGGGGCTCAACCCCGGAACTGCCTTTGATACTGGGTGTCTTGAGTGTGGAAGAGGTGAGTGGAATTCCGAG	False
TACGTAGGCAGCAAGCGTTGTTCGGAATTACTGGGCGTAAAGAGTGTGTAGGCGGTTTTCTAAGTTTGGTGTGAAATCTCCCGGCTTAACTGGGAGGGTGCGCCGAAAACTGGAAGGCTAGAGTGCCGGAGAGGATAGCGGAATTCCCGG	False
TACGGAGGATCCAAGCGTTATCCGGATTTATTGGGTTTAAAGGGTGCGTAGGCGGCCTGTTAAGTCAGGGGTGAAAGACGGTAGCTCAACTATCGCAGTGCCCTTGATACTGATGGGCTTGAATGGACTAGAGGTAGGCGGAATGAGACA	False
TACGAAGGGGGCTAGCGTTGCTCGGAATCACTGGGCGTAAAGGGTGCGTAGGCGGGTTTTTAAGTCAGAGGTGAAATCCTGGAGCTCAACTCCAGAACTGCCTTTGATACTGGGAATCTTGAGTATGGAAGAGGTGAGTGGAACTGCGAG	False
TACGGAGGATACAAGCGTTATCCGGATTTATTGGGTTTAAAGGGTGCGTAGGCGGCCTGTTAAGTCAGGGGTGAAAGACGGTAGCTCAACTATCGCAGTGCCCTTGATACTGATGGGCTTGAATGGACTAGAGGTAGGCGGAATGAGACA	False
TACGAAGGGGGCTAGCGTTGTTCGGAATTACTGGGCGTAAAGCGCACGTAGGCGGATATTTAAGTCAGGGGTGAAATCCCAGAGCTCAACTCTGGAACTGCCTTTGATACTGGGTATCTTGAGTATGGAAGAGGTGAGTGGAATTCCGAG	False
TACGTAGGGTCCAAGCGTTAATCGGAATTACTGGGCGTAAAGCGTGCGCAGGCGGTTGTGCAAGACCGATGTGAAATCCCCGAGCTTAACTTAGGAATTGCATTGGTGACTGCACGGCTAGAGTGTGTCAGAGGGGGGTAGAATTCCACG	False
GACGTAGGGAGCAAGCGTTGTCCGGATTTACTGGGCGTAAAGAGCGCGTAGGCGGTCTGTTAAGTGAGAAGTGAAATCTCCAGGGCTCAACCCGGAAACTGCTTTTCATACTGGCAGACTTGAGTGATGCAGAGGTATGTGGAATTCCTG	False
TACGTAGGCAGCAAGCGTTGTTCGGAACTACTGGGCGTAAAGAGTGTGTAGGCGGTTTTCTAAGTTTGGTGTGAAATCTCCCGGCTTAACTGGGAGGGTGCGCCGAAAACTGGAAGGCTAGAGTGCCGGAGAGGATAGCGGAATTCCCGG	False
TACGGAGGATGCGAGCGTTATCCGGATTTACTGGGTGTAAAGGGAGCGTAGACGGCGTGCCAAGTCTGGTGTGAAAGGCCGGGGCTCAACCCCGGGACTGCTCTTGGAACTGCGTGGCTGGAGTGCAGGAGGGGCAGGCGGAATTCCTGG	False
GACGGGGGGGGCAAGTGTTCTTCGGAATGACTGGGCGTCAAGGGCACGTAGGCGGTGAATCGGGTTGAAAGTGAAAGTCGCCAAAAACTGGTGGAATGCTCTCGAAACCAATTCACTTGAGTGAGACAGAGGAGAGTGGAATTTCGTGTG	False
TACGTAGGGTGCGAGCGTTAATCGGAATTACTGGGCGTAAAGCGTGCGCAGGCGGTTTCGTAAGACAGAGGTGAAATCCCCGGGCTCAACCTGGGAACTGCCTTTGTGACTGCGAGGCTAGAGTACGGCAGAGGGGGGTGGAATTCCACG	False
TACGTAGGGTGCGAGCGTTAATCGGAATTACTGGGCGTAAAGCGTGCGCAGGCGGTTATGTAAGACAGAGGTGAAATCCCCGGGCTCAACCTGGGAACTGCCTTTGTGACTGCATAGCTAGAGTACGGCAGAGGGGGATGGAATTCCGCG	False
TACGTAGGGTGCAAGCGTTAATCGGAATTACTGGGCGTAAAGCGTGCGCAGGCGGTCGTGCAAGACAGATGTGAAATCCCCGGGCTCAACCTGGGAACTGCATTTGTGACTGCACGGCTAGAGTACGGTAGAGGGGGATGGAATTCCGCG	False
TACGTAGGGTGCGAGCGTTGTCCGGAATTACTGGGCGTAAAGAGCTCGTAGGTGGTTTGTCGCGTCGTCTGTGAAATCCCGGGGCTTAACTTCGGGCGTGCAGGCGATACGGGCATAACTAGAGTGCTGTAGGGGAGACTGGAATTCCTG	False
TACAGAGGGTGCAAGCGTTAATCGGAATTACTGGGCGTAAAGCGTGCGTAGACGGTTGTTTAAGTCGGATGTGAAATCCCCTGGCTCAACCTGGGAATTGCATTCGAAACTGAACTGCTAGGGTACGGAAGAGGGAAGCGGAATTTCCGG	False
TACGAAGGGGGCTAGCGTTGCTCGGAATTACTGGGCGTAAAGGGAGCGTAGGCGGACATTTAAGTCAGGGGTGAAATCCCGGGGCTCAACCTCGGAATTGCCTTTGATACTGGGTGTCTTGAGTGTGATAGAGGTAAGTGGAACTCCGAG	False
TACGTAGGGGGCAAGCGTTATCCGGATTCATTGGGCGTAAAGCGCGCGTAGGCGGCTTGTTAAGCGAGGTGTGAAATCCGGGGGCTTAACCCGCGGCTTGCATCTCGAACTGGCAGGCTTGAGTTTGGTAGAGGAGTGTGGAATTCCCAG	False
TACGTAGGGTGCAGGCGTTAATCGGAATTACTGGGCGTAAAGCGTGCGCAGGCGGTTTGCTAAGACAGGTGTGAAATCCCCGGGCTTAACCTGGGAACTGCGCTTGTAACTAGCAGGCTAGAGTGTGGCAGAGGGGGGTGGAATTCCACG	False
TACAGAGGGTGCGAGCGTTGTCCAGAATTACTGGGCGTAAAGGGCGCGTAGGCGGTCCGTCACGCGTGCCGTGAAAGCCCGGGGCTCAACCCCGGGTCGGCGGTGCGAACGGGGGGACTGGAGCACACCAGAGGCAGGCGGAATTCCGGG	False
TACGTAGGGTGCGAGCGTTAATCGGAATTACTGGGCGTAAAGCGTGCGCAGGCGGTTTCGTAAGACAGACGTGAAATCCCCGGGCTCAACCTGGGAACTGCGTTTGTGACTGCGAGGCTAGAGTATGGCAGAGGGGGGTGGAATTCCACG	False
TACGAAGGGGGCTAGCGTTGTTCGGAATTACTGGGCGTAAAGCGCACGTAGGCGGATCGATCAGTCAGGGGTGAAATCCCAGAGCTCAACTCTGGAACTGCCTTTGATACTGTCGATCTAGAGTATGGAAGAGGTGAGTGGAATTCCGAG	False
TACAGAGGGTGCGAGCGTTGTCCTGAATTACTGGGCGTAAAGGGCGCGTAGGCGGTCCGTCGCGCGTGCCGTGAAAGCCCGGGGCTCAACCCCGGGTCGGCGGTGCGAACGGGGGGACTGGAGCACACCAGACGCAGGCGGAATTCCGGG	False
TACGAAGGGTGCAAGCGTTACTCGGAATTACTGGGCGTAAAGCGTGCGTAGGTGGTTCGTTAAGTCTGATGTGAAAGCCCTGGGCTCAACCTGGGAATTGCATTGGATACTGGCGGGCTAGAGTGCGGTAGAGGATGGCGGAATTCCCGG	False
TACAGAGGGTGCGAGCGTTGTCCTGAATTACTGGGCGTAAAGGGCGCGTAGGCGGTCCGTCACGCGTGCCGTGAAAGCCCGGGGCTCAACCCCGGGTCGGCGGTGCGAACGGGGGGACTGGAGCACACCAGACGCAGGCGGAATTCCGGG	False
TACAGAGGGTGCGAGCGTTGTCCGGAATTACTGGGCGTAAAGGGCGCGTAGGCGGTCCGTCACGCGTGCCGTGAAAGCCCGGGGCTCAACCCCGGGTCGGCGGTGCGAACGGGGGGACTGGAGCACACCAGAGGCAGGCGGAATTCCGGG	False
TACGAAGGGGGCGAGCGTTATTCGGAATCACTGGGCGTAAAGCGTGCGTAGGCTGTTTTGTAAGTCAGAAGTGAAAGCCCAGGGCTTAACCCTGGAATTGCTTTTGAAACTACAAGACTCGAATTCGGGAGAGGATAGCGGAATTGTCAG	False
TACGTAGGGTGCGAGCGTTGTCCGGATTTATTGGGCGTAAAGGGCTCGTAAGTGGTTGATCGCGTCGGAAGTGTAATCTTGGGGCTTAACCCTGAGCGTGCTTTCGATACGGGTTGACTTGAGGAAGGTAGGGGAGAATGGAATTCCTGG	False
TACGTAGGGTGCGAGCGTTAATCGGAATTACTGGGCGTAAAGCGTGCGCAGGCGGTTTTGTAAGACAGAGGTGAAATCCCCGGACTCAACCTGAGAACTGCCTTTGTGACTGCAAGGCTTGAGTGCGGCAGAGGGGGATGGAATTCCGCG	False
TACGAAAGGTGCGAGCGTTAATCGGAATTACTGGGCGTAAAGCGCGCGTAGGCGGCTATTTAAGTCTGATGTGAAATCCCCGGGCTCAACCTGGGAATTGCATCGGATACTGACTAGCTAGAATGCGGTAGAGGGGGGTGGAGTTCCAGG	False
TACAGAGGGTGCGAGCGTTGTCCAGAATTACTGGGCGTAAAGGGCGCGTAGGCGGTCCGTCACGCGGGCCGTGAAAGCCCGGGGCTCAACCCCGGGTCGGCGGTGCGAACGGGGGGACTGGAGCACACCAGAAGCAGGCGGAATTCCGGG	False
ATACGTTCCCGGGGCTTGTACACACCGCCCGTCAAGTCATGAAAGTTGGTAACACCCGAAGCCGGTGGCCTAACCGTTGTGGGGGAGCCGTCGAAGGTGGGACTGGTGATTAGGACTAAGTCGTAACAAGGTAGCCGTACCGGAAGGTGC	False
TACGTATGGAGCGAGCGTTGTCCGGAATTATTGGGCGTAAAGGGTACGCAGGCGGTTTAATAAGTCGAGTGTTAAAGATCGGGGCTCAACCCCGTAAAGCATTGGAAACTGATAAACTTGAGTAGTGGAGAGGAAAGTGGAATTCCTAGT	False
TACAGAGGGTGCGAGCGTTAATCGGAATTACTGGGCGTAAAGCGCGCGTAGGCGGTTTGTTAAGTCGGATGTGAAATCCCCGGGCTCAACCTGGGAATTGCATTCGATACTGGCAAGCTAGAGTATGGGAGAGGAAGGTAGAATTCCAGG	False
TACGGAGGGGGCTAGCGTTGTTCGGAATTACTGGGCGTAAAGCGCACGTAGGCGGACCAGAAAGTTGGGGGTGAAATCCCGGGGCTCAACCTCGGAACTGCCTTCAAAACTATTGGTCTGGAGTTCGAGAGAGGTGAGTGGAATTCCGAG	False
TACGTAGGGGGCAAGCGTTATCCGGATTTACTGGGTGTAAAGGGCGTGTAGGCGGGAAAGCAAGTCAGCGGTAAAATTGAGAGGCTCAACCTCTTCCCGCCGTTGAAACTGGTGGTCTTGAGTGGATGAGAAGTACGCGGAATGCGTGGT	False
TACGTAGGGTGCAAGCGTTAATCGGAATTACTGGGCGTAAAGCGTGCGCAGGCGGTTTTGTAAGACAGGTGTGAAATCCCCGGGCTTAACCTGGGAACTGCATTTGTGACTGCAAGGCTAGAGTACGGTAGAGGGGGATGGAATTCCGCG	False
TACAGAGGGTGCAAGCGTTAATCAGAATGACTGGGCGTAAAGGGCGTGTAGGTGGTTGACTAGGTTTGATGTGAAATCCCCGGGCTTAACCTGGGAATGGCGTCGAAAACGGGTTGACTGGAGTGAGAGAGAGGGTTGTGGAATTTCCGG	False
TACGGAGGGGGCTAGCGTTGTTCGGAATTACTGGGCGTAAAGCGCACGTAGGCGGACCAGAAAGTTGGGGGTGAAATCCCGGGGCTCAACCTCGGAACTGCCTTCAAAACTACTGGTCTCGAGTTCGAGAGAGGTGAGTGGAATTCCGAG	False
TACGTAGGGTGCGAGCGTTGTCCGGAATTATTGGGCGTAAAGAGCTCGTAGGCGGTGTGTCACGTCGGCCGTGAAAACCTGGGGCTTAACTCTGGGCGTGCGGTCGATACGGGCATCACTAGAGTTCGGCAGGGGAGACTGGAATTCCTG	False
TACGGAGGGGGCTAGCGTTGTTCGGAATTACTGGGCGTAAAGCGCACGTAGGCGGACCGGAAAGTCAGAGGTGAAATCCCAGGGCTCAACCTTGGAACTGCCTTTGAAACTCCTGGTCTTGAGGTCGAGAGAGGTGAGTGGAATTCCGAG	False
TACGAAGGGTGCAAGCGTTAATCGGAATTACTGGGCGTAAAGCGCGCGTAGGTGGTTCAGTAAGTTGGATGTGAAATCCCCGGGCTCAACCTGGGAACTGCATCCAAAACTGCTGAACTAGAGTACGGTAGAGGGTGGTGGAATTTCCTG	False
TACGGAGGATGCAAGCGTTATCCGGAATGATTGGGCGTAAAGCGTCCGCAGGTGGCACTTCAAGTCGATTGTTAAAGGTCGAGGCTCAACCTCGAACAGGCAGTGGAAACTGAAGAGCTAGAGTGCGGTAGGGGCAGAGGGAATTCCCGG	False
TACGTAGGGTGCGAGCGTTAATCGGAATTACTGGGCGTAAAGCGTGCGCAGGCGGTTTTGTAAGACAGAGGTGAAATCCCCGGGCTCAACCTGGGAACTGCCTTTGTGACTGCAAGGCTTGAGTGCGGCAGAGGGGGATGGAATTCCGCG	False
TACGTAGGGAGCGAGCGTTGTCCGGAATCATTGGGCGTAAAGCGCGCGTAGGCGGCCCGATAAGTCTGCTGTGAAAGTCAACGGCTCAACCGTTGGATGCCGGTGGATACTGTCGGGCTAGAGTACGGAAGAGGCAAGTGGAATTCCTGG	False
TACGTAGGGTGCAAGCGTTGTCCGGAATTATTGGGCGTAAAGAGCTCGTAGGCGGTTGGTCGCGTCGGCTGTGAAAACCCGGAGCTCAACTCCGGGCCGGCAGTCGATACGGGCCGACTCGAGTGGTGCAGGGGAGACTGGAATTCCTGG	False
TACGGAGGGAGCTAGCGTTATTCGGAATTACTGGGCGTAAAGCGCACGTAGGCGGCTTTGTAAGTAAGAGGTGAAAGCCCAGAGCTCAACTCTGGAATTGCCTTTTAGACTGCATCGCTTGAATCATGGAGAGGTCAGTGGAATTCCGAG	False
TACGTAGGGTGCGAGCGTTAATCGGAATTACTGGGCGTAAAGCGTGCGCAGGCGGTTTTGTAAGGCAGAGGTGAAATCCCCGGGCTCAACCTGGGAACTGCCTTTGTGACTGCAAGGCTTGAGTGCGGCAGAGGGGGATGGAATTCCGCG	False
TACGGAGGGGGCTAGCGTTATTCGGAATTACTGGGCGTAAAGCGCACGTAGGCGGCTTTGTAAGTAAGAGGTGAAAGCCCAGAGCTCAACTCTGGAATTGCCTTTTAGACTGCATCGCTTGAATCATGGAGAGGTCAGTGGAATTCCGAG	False
TACGGAGGGGGCTAGCGTTGTTCGGGATTACTGGGCGTAAAGCGCACGTAGGCGGACTGGAAAGTCAGAGGTGAAATCCCAGGGCTCAACCTTGGAACTGCCTTTGAAACTATCAGTCTGGAGTTCGAGAGAGGTGAGTGGAATTCCGAG	False
TACGTAGGGTGCGAGCGTTAATCGGAATTACTGGGCGTAAAGCGTGCGCAGGCGGATTGTTAAGCAAGACGTGAAATCCCCGGGCTTAACCTGGGAATGGCGTTTTGAACTGGCAGTCTAGAGTGTGTCAGAGGGGGGTGGAATTCCACG	False
TACGAAGGGGGCTAGCGTTGCTCGGAATCACTGGGCGTAAAGGGTGCGTAGGCGGGTTTCTAAGTCAGAGGTGAAAGCCTGGAGCTCAACTCCAGAACTGCCTTTGATACTGGAAGTCTTGAGTATGGCAGAGGTGAGTGGAACTGCGAG	False
TACGTAGGTCCCGAACGTTGCGCGAAATTACTGGGCGTAAAGGGTCCGTAGGCGGTCTGGTAAGTGGAAGGTGAAATCCTACGGCTCAACCGTAGAATTGCCTTCCAAACTGCTGGACTTGAGGCAGGGAGAGGTCGGCGGAATTCCCGG	False
TACGTAGGGTGCGAGCGTTAATCGGAATTACTGGGCGTAAAGCGTGCGCAGGCGGTTGTGTAAGACAGGTGTGAAATCCCCGGGCTTAACCTGGGAACTGCGCTTGTGACTGCACGGCTAGAGTATGGCAGAGGGGGGTGGAATTCCACG	False
CACGTAGGGTGCGAGCGTTGTCCGGAATTATTGGGCGTAAAGAGCTCGTAGGCGGTGTGTCGCGTCGGCCGTGAAAACTTGGGGCTTAACTCTGAGCGTGCGGTCGATACGGGCATCACTTGAGTTCGGCAGGGGAGACTGGAATTCCTG	False
TACGAAGGGGGCTAGCGTTGCTCGGAATCATTGGGCGTAAAGGGCGCGTAGGCGGCGCGGTTGGTCAGGCGTGAAATCCCCGGGCTCAACCCAGGGACTGCGCTTGATACGGCCGGGCTGGAGGATGGAAGAGGGCCGCGGAATTCCCAG	False
TACAGAGGATGCAAGCGTTATCCGGAATGATTGGGCGTAAAGCGTCTGTAGGTGGCTTTTTAAGTCCGCCGTCAAATCCCAGGGCTCAACCTTGGACAGGCGGTGGAAACTACCAAGCTGGAGTACGGTAGGGGCAGAGGGAATTTCCGG	False
TACGAAGGGGGCTAGCGTTGCTCGGAATCACTGGGCGTAAAGGGCGCGTAGGCGGCGCCTCTAGTCGGGCGTGAAATCCCCGGGCTCAACCCGGGGGCTGCGCCCGATACGGGGGCGCTGGAGGCGAGGAGAGGCCCGCGGAATTCCCAG	False
TACGTAGGGGGCGAGCGTTATCCGGAATTATTGGGCGTAAAGCGCGCGCAGGCGGCTGATTAAGTCAGGTGTGAAAGGCTGCGGCTCAACCGCAGAGCGGCACCTGAAACTGGTCAGCTTGAGTGCAGGAGAGGGGAGCGGAATTCCCGG	False
TACGAAGGGGGCTAGCGTTGCTCGGAATCACTGGGCGTAAAGGGTGCGTAGGCGGGTTTCTAAGTCAGAGGTGGAAGCCTGGAGCTCAACTCCAGAACTGCCTTTGATACTGGAAGTCTTGAGTATGGCAGAGGTGAGTGGAACTGCGAG	False
TACGAAGGGTGCAAGCGTTAATCGGAATTACTGGGTGTAAAGCGTGCGTAGGCGGTTTGTTAAGTCAGGTGTGAAAGCCCCGGGCTCAACCTGGGAACTGCATTTGATACTGGCAGGCTAGAGTACGGTAGAGGGTGGTGGAATTCCCGG	False
TACGAAGGGGGCTAGCGTTGCTCGGAATCATTGGGCGTAAAGGGCGCGTAGGCGGCGCGGTTGGTCAGGCGTGAAATCCCCGGGCTCAACCCAGGGACTGCGCTTGATACGGCCGGGCTGGAGGATGGAAGAGGGCCGCGGACTTCCCAG	False
CACGTAGGGTGCGAGCGTTGTCCGGAATTATTGGGCGTAAAGAGCTCGTAGGCGGTGTGTCGCGTCGGCCGTGAAAACTTGGGGCTTAACTCTGAGCGTGCGGTCGATACGGGCATCACTTGAGTTCGGCAGGGGAGACTGCAATTCCTG	False
AACGGGGGGGGCAAGTGTTCTTCGGAATGACTAGGCGTAAAGGGCACGTAGGCGGTTCATCGGGTTGAAAGTGAAAGTCGTCAAAAAGTGGCGGAATGCTTTCGAAACCACTGAACTTGAGTGAGACGGAGGAGAGTGGAATTTCGTGTG	False
TACGTAGGTGGCAAGCGTTATCCGGATTTACTGGGTGTAAAGGGCGTGTAGGCGGGAAAGCAAGTCAGATGTGAAAACCATGGGCTCAACCTGTGGCCTGCATTTGAAACTGGTGGTCTTGAATGGATGAGAAGTACGCGGAATGCGTGG	False
TACGTAGGGTGCAAGCGTTAATCGGAATTACTGGGCGTAAAGCGTGCGCAGGCGGTTTTGTAAGACAGAGGTGAAATCCCCGGGCTCAACCTGGGAACTGCCTTTGTGACTGCAAGGCTGGAGTGCGGCAGAGGGGGATGGAATTCCGCG	False
TTCGTAGGGGGCTAGCGTTATCCGGATTTACTGGGCGTAAAGGGTGCGTAGGTGGTTTCTTAAGTCAGGAGTGAAAGGCTACAGCTCAACCGTAGTAAGCTCTTAAAACTGGGAAACTTGAGTGCAGGAGAGGAAAGTGGAATTCCTAGT	False
TACGTAGGTGGCAAGCGTTATCCGGAATTATTGGGCGTAAAGCGCGCGCAGGTGGTTTCTTAAGTCTGATGTGAAAGCCCACGGCTCAACCGTGGAGGGTCATTGGAAACTGGGAGACTTGAGTGCAGAAGAGGAAAGTGGAATTCCATG	False
TACGGGGGATGCGAGCGTTATCCGGATTTATTGGGTTTAAAGGGTGCGTAGGCGGATTGTCAAGTCAGTGGTGAAAACTTTAGGCTTAACCTAAAGCTTGCCATTGATACTGATGATCTAGAATATGGATGATGTTGGCGGAATGTGTAA	False
TACGTAGGGAGCGAGCGTTGTCCGGATTTACTGGGTGTAAAGGGTGCGTAGGCGGGTAAGCAAGTCAGAAGTGAAATCCATGGGCTTAACCCATGAACTGCTTTTGAAACTGTTTATCTTGAGTGAAGTAGAGGTAGGCGGAATTCCCGG	False
TACGTAGGTGGCAAGCGTTATCCGGATTTATTGGGCGTAAGGGGAACGCAGGCGGTCTTTTAAGTCTGATGTGAAAGCCTTCGGCTTAACCGGAGTAGTGCATTGGAAACTGGGAGACTTGAGTGCAGAAGAGGAGAGTGGAACTCCATG	False
TACGTAGGTGGCAAGCGTTGTCCGGATTTACTGGGTGTAAAGGGCGTGCAGCCGGAGAGACAAGTCAGATGTGAAAACCATGGGCTCAACCTGTGGCCTGCATTTGAAACTGTTTTTCTTGAGTACTGGAGAGGCAGACGGACTTCCTAG	False
TACGGAGGATGCGAGCGTTATCCGGATTTACTGGGTGTAAAGGGAGCGTAGACGGCTAAGCAAGTCTGAAGTGAAAGCCCGGGGCTTAACCCCGGGACTGCTTTGGAAACTGTTAAGCTAGAGTGCTGGAGAGGTAAGTGGAATTCCTAG	False
TACGGGGGGTGCAAGCGTTGTTCGGAATCATTGGGCGTAAAGAGCGTGTAGGCGGATGGATAAGTCAGATGTGAAAGCCCTGGGCTTAACCCAGGAAGTGCATTTGAAACTATTCAGCTGGAGTAAGGGAGAGGAAAGTGGAATTCCTGG	False
TACGGAGGATGCGAGCGTTATCCGGATTTATTGGGTTTAAAGGGTGCGTAGGCGGCCTGCCAAGTCTGATGTGAAATACCGGGGCTCAACCCCGGGACTGCTTTGGAAACTGTATGGCTGGAGTGCTGGAGAGGCAAGCGGAATTCCTAG	False
TACGTAGGTGGCGAGCGTTATCCGGATTTACTGGGTGTAAAGGGTGTGTAGGCGGGGATGCAAGTCAGATGTGAAATTCCGAGGCTTAACCACGGAACTGCATTTGAAACTGCAACTCTTGAGAGTCGGAGAGGTAAGCGGAATTCCCGG	False
TACGAAGGGGGCTAGCGTTGCTCGGAATCACTGGGCGTAAAGGGTGCGTAGGCGGGTTTCTAAGTCAGAGGTGAAATCCTGGAGCTCAACTCCAGAACTGCCTTTGATACTGGAAGTCTTGAGTATGGGAGAGGTGAGTGGAACTGCGAG	False
TACGAAGGGGGCTAGCGTTGTTCGGAATTACTGGGCGTAAAGCGTACGTAGGCGGATTGTTAAGTGAGGGGTGAAATCCCGAGGCTCAACCTCGGAACTGCCTTTCATACTGGCAATCTTGAGTCCGGGAGAGGTGAGTGGAACTCCTAG	False
TACATAGGGAGCGAGCGTTATCCGGATTTATTGGGTGTAAAGGGTGCGTAGACGGGAATACAAGTTGGTTGTGAAAGCCCTCGGCTTAACTGAGGAACTGCAACCAAAACTATATTTCTTGAGTATCGGAGAGGAAAGTGGAATTCCTAG	False
TACGGAGGATGCGAGCGTTATCCGGATTTATTGGGTTTAAAGGGTGCGTAGACGGGAAAACAAGTTAGTTGTGAAATCCCTCGGCTTAACTGAGGAACTGCAACTAAAACTATTTTTCTTGAGTGCAGGAGAGGTAAGTGGAATTCCTAG	False
TACGTAGGTGGCAAGCGTTGTCCGGAATCATTGGGCGTAAAGCGCGCGCAGGCGGTCCCTTAAGTCTGATGTGAAAGCCCACGGCTCAACCGTGGAGGGTCATTGGAAACTGGGGGACTTGAGTGCAGAAGAGGAAAGCGGAATTCCAAG	False
GACGTAGGGGGCGAGCGTTGTCCGGAATTACTGGGCGTAAAGGGCGCGTAGGCGGCCGTTCAAGTCAGGTGTAAAATACCCGGGCTCAACCCGGGGATAGCACTTGAAACTGGGCGGCTAGAGGGCAGGAGAGGGGAGTGGAATTCCCGG	False
TACGTAGGTGGCAAGCGTTGTCCGGAATTATTGGGCGTAAAGCGCGCGCAGGCGGTTCCTTAAGTCTGATGTGAAAGCCCACGGCTCAACCGTGGAGGGTCATTGGAAACTGGGGAACTTGAGTGCAGAAGAGAAGAGCGGAATTCCACG	False
TACGTAGGTGGCAAGCGTTGTCCGGAATTATTGGGCGTAAAGCGCGCGCAGGCGGTCTCTTAAGTCTGATGTGAAAGCCCACGGCTCAACCGTGGAGGGTCATTGGAAACTGGGAGACTTGAGTACAGAAGAGGAGAGTGGAATTCCATG	False
TACGTAGGGGGCGAGCGTTGTCCGGAATTACTGGGCGTAAAGAGTTCGTAGGCGGTTTGATAAGTCAGATGTGAAAGGCGTAGGCTTAACCTATGTAAGCATATGAAACTGTCAGACTTGAGGTAAGGAGAGGAAAGTGGAATTCCTAGT	False
TACGTAGGGGGCGAGCGTTGTCCGGAATTACTGGGCGTAAAGAGTTCGTAGGCGGTTTGATAAGTCAGATGTGAAAGGCGTAGGCTCAACCTATGTAAGCATATGAAACTGTCAGACTTGAGGTAAGGAGAGGAAAGTGGAATTCCTAGT	False
TACGTAGGGTGCGAGCGTTGTCCGGAATTATTGGGCGTAAAGAGCTTGTAGGTGGTTTGTCGCGTCTGCTGTGAAAATCCGGGGCTCAACCCCGGACTTGCAGTGGGTACGGGCAGACTAGAGTGTGGTAGGGGAGACTGGAATTCCTGG	False
TACGTAGGGTGCGAGCGTTGTCCGGAATTACTGGGCGTAAAGAGCTCGTAGGTGGTTTGTCGCGTCGTCTGTGAAATTCCGGGGCTTAACTCCGGGCGTGCAGGCGATACGGGCAAGCTGGAGTGCTGTAGGGGAGACTGGAATTCCTGG	False
TACGTAGGGTGCAAGCGTTAATCGGAATTACTGGGCGTAAAGCGTGCGCAGGCGGTTATGTAAGACAGAGGTGAAATCCCCGGGCTCAACCTGGGAACTGCCTTTGTGACTGCATAGCTAGAGTACGGTAGAGGGGGATGGAATTCCGCG	False
TACGTAGGGGGCTAGCGTTATCCGGAATTACTGGGCGTAAAGGGTGCGTAGGTGGGTTTTTAAGTCAGAGGTGAAAGGCTACGGCTCAACCGTAGTAAGCCTTTGAAACTGAGAAACTTGAGTGCAGGAGAGGAGAGTAGAATTCCTAGT	False
TACGGGAGGAGCGAGCATTATTCGGAATGATTAGGCGTAAAGGGTTTGTAGGTGGTTTTTTAAGTTGAAAGAAACAAATTAAAGCTTAACTTTATACATTTTTTCAAAACTAAAAAACTTGAGTATAAATAGAGGATAATGGAATTTCTA	False
TACGTAGGGGGCAAGCGTTATCCGGATTTACTGGGTGTAAAGGGAGCGCAGACGGCGAAGCAAGTCTGAAGTGAAATGCATGGGCTCAACCCATGAATTGCTTTGGAAACTGTTTGGCTTGAGTGTCGGAGGGGTAAGCGGAATTCCTAG	False
TACAGAGGGTGCAAGCGCTAATCGGAATTACTGGGCGTAAAGCGCGCGTAGGCGGTTGTGTAAGTTGGAGGTGAAATCCCCGGGCTTAACCTGGGCACTGCCTTCAAAACTGCACGGCTAGAGTATGGGAGAGGAAGGTAGAATTCCAGG	False
TACGTATGTCACAAGCGTTATCCGGATTTATTGGGCGTAAAGCGCGTCTAGGTGGTTATGTAAGTCTGATGTGAAAATGCAGGGCTCAACTCTGTATTGCGTTGGAAACTGCATGACTAGAGTACTGGAGAGGTAAGCGGAACTACAAGT	False
TACGAAGGGGGCAAGCGTTGCTCGGAATGACTGGGCGTAAAGGGCGCGTAGGCGGTTTGCACCGTCAGATGTGAAATTCCCGGGCTCAACCTGGGGGCTGCATTTGATACGTGTGGACTTGAGTGGGGAAGAGGGTCGTGGAATTCCCAG	False
TACGAAGGGGGCTAGCGTTGCTCGGAATCACTGGGCGTAAAGGGTGCGTAGGCGGGTCTTTAAGTCAGGGGTGAAATCCTGGAGCTCAACTCCAGAACTGCCTTTGATACTGAAGATCTTGAGTTCGGGAGAGGTGAGTGGAACTGTGAG	False
TACGAAGGGGGCTAGCGTTGCTCGGAATCACTGGGCGTAAAGGGCGCGTAGGCGGACTTTTAAGTCGGAGGTGAAAGCCCAGGGCTCAACCCTGGAATTGCCTTCGATACTGGGAGTCTTGAGTTCGGAAGAGGTTGGTGGAACTGCGAG	False
CACGTAGGGTGCGAGCGTTGTCCGGAATTATTGGGCGTAAAGAGCTCGTAGGCGGTGTGTCGCGTCGGCCGTGAAAACCTGCAGCTTAACTGTGGGCTTGCGGTCGATACGGGCATCACTGGAGTTCGGCAGGGGAGACTGGAATTCCTG	False
TACGTAGGGTGCAAGCGTTAATCGGAATTACTGGGCGTAAAGCGTGCGCAGGCGGTTGTGTAAGTCAGATGTGAAATCCCCGGGCTCAACCTGGGAATTGCATTTGAGACTGCACGGCTAGAGTGTGTCAGAGGGGGGTAGAATTCCACG	False
TACGTAGGGTGCAAGCGTTGTCCGGAATTATTGGGCGTAAAGAGCTCGTAGGCGGTTTGTCGCGTCTGCTGTGAAAACCCGAGGCTCAACCTCGGGCCTGCAGTGGGTACGGGCAGACTAGAGTGCGGTAGGGGAGATTGGAATTCCTGG	False
TACGTAGGGGGCAAGCGTTATCCGGGTTTACTGGGTGTAAAGGGAGCGCAGACGGCGAAGCAAGTCTGAAGTGAAATGCATGGGCTCAACCCATGAATTGCTTTGGAAACTGTTTGGCTTGAGTGTCGGAGGGGTAAGCGGAATTCCTAG	False
TACGTAGGGTGCAAGCGTTAATCGGAATTACTGGGCGTAAAGCGTGCGCAGGCGGTTGTGTAAGTCAGATGTGAAATCCCCGGGCTCAACCTGGGAATTGTATTTGAGACTGCACGGCTAGAGTGTGTCAGAGGGGGGTAGAATTCCACG	False
TACGTAGGGTGCAAGCGTTAATCGGAATTACTGGGCGTAAAGCGTGCGCAGGCGGTTATGTAAGTCAGATGTGAAATCCCCGGGCTCAACCTGGGAATGGCATTTGAGACTGCATGGCTAGAGTGTGTCAGAGGGGGGTAGAATTCCACG	False
TACGTAGGGTGCAAGCGTTAATCGGAATTACTGGGCGTAAAGCGTGCGCAGGCGGTTATGTAAGTCAGATGTGAAATCCCCGGGCTCAACCTGGGAATGGCATTTGAGACTGCATGGCTAGAGTGTGTCAGAGGGGGGTAGAATTCCCCG	False
TACGTAGGGTGCAAGCGTTAATCGGAATTACTGGGCGTAAAGCGTGCGCAGGCGGTTATGCAAGACAGAGGTGAAATCCCCGGGCTCAACTTGGGAACTGCCTTTGTGACTGCATGGCTAGAGTACGGTAGAGGGGGATGGAATTCCGCG	False
TACGTAGGGAGCAAGCGTTATCCGGATTTACTGGGTGTAAAGGGCGTGTAGGCGGGCCTGCAAGTCAGAAGTGAAATCTGGGGGCTTAACCCCCAAACTGCTTTTGAAACTGTATTTCTTGAGTGCTGGAGAGGCAATCGGAATTCCGTG	False
TACGGAGGATGCGAGCGTTATCCGGATTTATTGGGTTTAAAGGGTGCGTAGGCGGACTGTCAAGTCAGCGGTAAAATTGCGGGGCTCAACCCCGTCGAGCCGTTGAAACTGGCAGACTTGAGTTGGCGAGAAGTACGCGGAATGCGTGGT	False
TACGTATGGTGCGAGCGTTGTCCGGATTTACTGGGCGTGAAGGGGGCGCAGGCGGCGCGCCAAGCCCGATGTGAAAGCCCGGGGCCCAACCCCGGGACTGCTCTTGGAACTGCGTGGCTGGAGTGCAGGAGGGGCAGGCGGAATTCCTAG	False
TACGGAGGATGCGAGCGTTATCCGGATTTACTGGGTGTAAAGGGCGTGTAGGCGGGACTGCAAGTCAGATGTGAAAACCACGGGCTCAACCTGTGGCCTGCATTTGAAACTGTTGGTCTTGAGTATCGGAGAGGCAGGCGGAATTCCTAG	False
TACGTAGGTGGCAAGCGTTATCCGGAATTATTGGGCGTAAAGCGCGCGTAGGCGGTTTTTTAAGTCTGATGTGAAAGCCCACGGCTCAACCGTGGAGGGTCATTGGAAACTGAAAAACTTGAGTGCAGAAGAGGAAAGTGGAATTCCATG	False
TACGTAGGGTGCGAGCGTTAATCGGAATTACTGGGCGTAAAGCGTGCGCAGGCGGCTTTGCAAGACAGATGTGAAATCCCCGGGCTCAACCTGGGAACTGCATTTGTGACTGCATCGCTAGAGTGCGGCAGAGGGGGATGGAATTCCGCG	False
TACGTATGTCGCAAGCGTTATCCGGAATTATTGGGCATAAAGGGCATCTAGGCGGCCCTGTAAGTCTAGGGTGAAAACCTGCGGCTCAACCGCAGGCCTGCCCCGGAAACTACAGGGCTAGAGTATCGGAGAGGTGGACGGAACTGCACG	False
TACGTAGGGGGCAAGCGTTATCCGGAATTACTGGGTGTAAAGGGTGCGTAGGCGGCCATGCAAGTCAGATGTGAAAACTCAGGGCTCAACTCTGAGGCTGCATCTGAAACTGTGTGGCTAGAGTGTGGGAGAGGAAAGTGGAATTCCGAG	False
TACGTAGGGGGCAAGCGTTATCCGGAATCACTGGGCGTAAAGGGTGCGTAGGCGGCCAATAAAGTCTAGGGTGAAAGGCTACGGCTCAACCGTAGTAAGCCTTGGAAACTTATTGGCTTGAGTGCAGGAGAGGAGAGTGGAATTCCTAGT	False
TACGTAGGGTGCGAGCGTTAATCGGAATTACTGGGCGTAAAGCGTGCGCAGGCGGTCGTGTAAGACAGGTGTGAAATCCCCGGGCTTAACCTGGGAACTGCGCTTGTGACTGCACGGCTAGAGTATGGCAGAGGGGGGTGGAATTCCACG	False
TACGTAGGGTGCGAGCGTTAATCGGAATTACTGGGCGTAAAGCGTGCGCAGGCGGTCTTGCAAGACAGGTGTGAAATCCCCGGGCTTAACCTGGGAACTGCACTTGTGACTGCAAGGCTGGAGTACGGCAGAGGGGGATGGAATTCCGCG	False
TACGGAGGATCCAAGCGTTATCCGGATTTATTGGGTTTAAAGGGTGCGTAGGCGGCTTATTAAGTCAGGGGTGAAAGACGGTGGCTCAACCATCGCAGTGCCTTTGATACTGATGAGCTTGAATATACTAGAGGTAGGCGGAATGTGACA	False
TACGTAGGGGGCAAGCGTTATCCAGATTTACTGGGTGTAAAGGGAGCGTAGACGGCGATGCAAGTCTGGAGTGAAAACCCGGGGCTCAACCCCGGGACTGCTTTGGAAACTGTGTTGCTAGAGTGCAGGAGAGGTAAGTGGAATTCCTAG	False
TACGTAGGGGGCAAGCGTTATCCGGATTTACTGGGTGTAAAGGGAGCGTAGACGGCGATGCAAGTCTGGAGTGAAAACCCGGGGCTCAACCCCGGGACTGCTTTGGAAACTGTGTTGCTAGAGTGCAGGAGAGGTAAGTGGAATTCCTAG	False
TACGGAGGATCCAAGCGTTATCCGGAATCATTGGGTTTAAAGGGTCCGTAGGCGGCTTTATAAGTCAGTGGTGAAATCCGGCAGCTCAACTGTCGAATTGCCATTGATACTGTAGGGCTTGAATGTTTGTGAAGTAACTAGAATATGTAG	False
TACGGAGGGTGCAAGCGTTAATCGGAATTACTGGGCGTAAAGCGCACGCAGGCGGTCTGTCAAGTCGGATGTGAAATCCCCGGGCTCAACCTAGGAACTGCATTCGAAACTGGTAGGCTTGAGTCTTGTAGAGGGGGGTAGAATTCCAGG	False
TACGGAGGATGCGAGCGTTATCCGGATTTACTGGGTGTAAAGGGAGCGCAGGCGGTCTGGCAAGTCTGATGTGAAAGCCCGGGGCCCAACCCCGGGACTGCTCTTGGAACTGCGTGGCTGGAGTGCAGGAGGGGCAGGCGGAATTCCTGG	False
TACGTAGGGTGCGAGCGTTGTCCGGAATTATTGGGTGTAAAGAGCTTGTAGGCGGTTTGTCGCGTCTGCTGTGAAAGACCGGGGCTTAACTCCGGTTCTGCAGTGGGTACGGGCAGACTAGAGTATGGTAGGGGAGACTGGAATTCCTGG	False
TACGGAGGGGGCTAGCGTTGTTCGGAATTACTGGGCGTAAAGCGCACGTAGGCGGATTGGCAAGTTGGGGGTGAAATCCCAGGGCTCAACCCTGGAACTGCCTCCAAAACTTCCAGTCTTGAGGTCGAGAGAGGTGAGTGGAATTCCGAG	False
CACGTAGGGTGCGAGCGTTGTCCGGAATTATTGGGCGTAAAGAGCTCGTAGGCGGTGTGTCGCGTCGGCCGTGAAAACCTGTGGCTTAACTGTGGGCTTGCGGTCGATACGGGCATCACTGGAGTTCGGCAGGGGAGACTGGAATTCCTG	False
TACGAAGGGTGCAAGCGTTAATCGGAATTACTGGGCGTAAAGCGTGCGTAGGCGGTTTGTTAAGTCCGATGTGAAAGCCCTGGGCTCAACCTGGGAATGGCATTGGATACTGGCAAGCTAGAGTGCGGTAGAGGGGTGCGGAATTCCCGG	False
TACAGAGGATGCGAGCGTTATCCGGATTTATTGGGTTTAAAGGGTGCGCAGGCGGGCTGTCAAGTCAGCGGTAAAATTGAGAGGCTCAACCTCTTCGAGCCGTTGAAACTGGCGGTCTTGAGTGAGCGAGAAGTACGCGGAATGCGTGGT	False
TACGTAGGGTGCAAGCGTTAATCGGAATTACTGGGCGTAAAGCGTGCGCAGGCGGTTTTGTAAGACAGTCGTGAAATCCCCGGGCTCAACCTGGGAATTGCGATTGTGACTGCAAAGCTGGAGTGCGGCAGAGGGGGATGGAATTCCGCG	False
TACGGAGGATGCGAGCGTTATCCGGATTCATTGGGCGTAAAGCGCGCGTAGGCGGCCAGTTAGGTCGGGAGTCAAATTTCGGGGCTCAACCCCGTCTCGCTCCCGATACCGGCTGGCTTGAGTGTGGTAGGGGAAGGCGGAATTCCCGGT	False
TACGTAGGGCGCAAGCGTTGTCCGGAATTATTGGGCGTAAAGAGCTCGTAGGCGGTCTGTCGCGTCTGCTGTGAAAACTCGAGGCTCAACCTCGGGCTTGCAGTGGGTACGGGCAGACTAGAGTGCGGTAGGGGAGACTGGAATTCCTGG	False
CACGTAGGCACCAAGCGTTGTCCGGATTTATTGGGCGTAAAGAGCTCGTAGGCGGTTCGGTAAGTCGGGTGTGAAAACTCTGGGCTCAACTCAGAGATGCCACTCGATACTGCTGTGACTCGAGTGCGGTAGGGGAGCGGGGAATTCCTG	False
TACGGGAGAGGCAAGCGTTGTTCGGAATCACTGGGCTTAAAGCGCGTGTAGGCGGCTCGGTAAGTACTTTGTGAAATCTCCCCTCTCAATGGGGAAATTGCTTGGTATACTGCCGAGCTTGAGGTAGGTAGGGGTGCCTGGAACTCTAGG	False
TACGTAGGTGGCAAGCGTTGTCCGGATTTATTGGGCATAAAGCGAGTGCAGGCGGTTCAATAAGTCTGATGTGAAAGCCTTCGGCTCAACCGGAGAATTGCATCAGAAACTGTTGAACTTGAGTGCAGAAGAGGAGAGTGGAACTCCATG	False
TACGAAGGGGGCTAGCGTTGTTCGGAATTACTGGGCGTAAAGCGCACGTAGGCGGACTTTTAAGTCAGGTGTGAAATCCCAGGGCTCAACCTCGGAACTGCATTTGAAACTGGAAGTCTTGAGATCAGGAGAGGTTAGCGGAATACCGAG	False
TACGTAGGGTGCAAGCGTTAATCGGAATTACTGGGCGTAAAGCGTGCGCAGGCGGTTTTGTAAGACAGGCGTGAAACCCCCGGGCTCAACCTGGGAATTGCGCTTGTGACTGCAAGGCTGGAGTGCGGCAGAGGGGGATGGAATTCCGCG	False
TACGTAGGTGGCAAGCGTTATCCGGATTTACTGGGTGTAAAGGGCGTGTAGGCGGGTCTGCAAGTCAGATGTGAAATTCCCGGGCTTAACTCGGGAGGGTCATCTGAAACTGCGGATCTTGAGTACTGGAGAGGATAGTGGAATTCCTAG	False
TACGTAGGGTGCGAGCGTTAATCGGAATTACTGGGCGTAAAGCGTGCGCAGGCGGTTTTTTAAGATAGGCGTGAAATCCCCGGGCTCAACCTGGGAACTGCGCTTATGACTGGAAGACTAGAGTATGGCAGAGGGGGGTGGAATTCCACG	False
TACGGAGGATGCGAGCGTTATCCGGATTTATCGGGTTTAAAGGGTGCGTAGGCGGTCCGTTAAGTCAGCGGTAAAATTGCGGGGCTCAACCCCGTCGAGCCGTTGAAACTGGCAGACTTGAGTTGGCGAGAAGTACGCGGAATGCGCGGT	False
TACGGAGGATGCGAGCGTTATCCGGATTTACTGGGTGTAAAGGGAGCGCAGGCGGCGCGTTAAGCCTGGTGTGAAAGCCCGCGGCCCAACCGCGGGACTGCTCTTGGAACTGCGTGGCTGGAGTGCAGGAGGGGCAGGCGGAATTCCTGG	False
TACAGAGGGTGCAAGCGTTGTTCGGAATTACTGGGCGTAAAGCGTGCGTAGTCGGTATTGAGAGTCACGGGTGAAATCCCAGGGCTTAACCCTGGAACTGCCTGTGAGACCTCAGTACTAGAGTGTGAGAGGGGATAGTGGAATACCCAG	False
TACGTAGGTGGCAAGCGTTGTCCGGAATTATTGGGCGTAAAGCGCGCGCAGGCGGTCCTTTAAGTCTGATGTGAAAGCCCACGGCTCAACCGTGGAGGGTCATTGGAAACTGGGGGACTTGAGTACAGAAGAGAAGAGTGGAATTCCACG	False
TACGGAGGGAGCTAGCGTTGTTCGGAATTACTGGGCGTAAAGCGCGCGTAGGCGGTTTTTTAAGTCAGAGGTGAAAGCCCGGGGCTCAACCCCGGAACTGCCTTTGAAACTGGAAAACTTGAATCTTGGAGAGGTCAGTGGAATTCCGAG	False
TACGGAGGGTGCAAGCGTTATCCGGAATCATTGGGTTTAAAGGGTCCGTAGGCGGATTAATAAGTCAGAGGTGAAATCCCACAGCTTAACTGTGGAACTGCCTTTGATACTGTTAGTCTTGAGTTATATGGAAGTAGATAGAATGTGTAG	False
TACGTAGGGTGCAAGCGTTAATCGGAATTACTGGGCGTAAAGCGTGCGCAGGCGGCTTTGCAAGACAGATGTGAAATCCCCGGGCTCAACCTGGGAACTGCATTTGTGACTGCAAGGCTGGAGTGCGGCAGAGGGGGATGGAATTCCGCG	False
TACGGAGGGTGCAAGCGTTACCCGGAATCATTGGGTTTAAAGGGTCCGTAGGCGGATTAATAAGTCAGAGGTGAAATCCCACAGCTTAACTGTGGAACTGCCTTTGATACTGTTAGTCTTGAGTTATATGGAAGTAGATGGAATGTGTAG	False
TACGTAGGGTGCAAGCGTTAATCGGAATTACTGGGCGTAAAGCGTGCGCAGGCGGTTATGTAAGACAGTTGTGAAATCCCCGGGCTCAACCTGGGAACTGCATCTGTGACTGCATAGCTAGAGTACGGTAGAGTGGGATGGAATTCCGCG	False
TACGTAGGTGGCAAGCGTTGTCCGGATTTACTGGGTGTAAAGGGCGTGTAGCCGGGTTGACAAGTCAGATGTGAAATCCTGCGGCTTAACCGCAGAACTGCATTTGAAACTGTTGATCTTGAGTACTGGAGAGGCAGACGGAAATCCTAG	False
TATAAGACAGATGTGAAATCCCCGGGCTCAACCTGGGACCTGCATTTGTGACTGTATCGCTAGAGTACGGTAGAGGGGGATGGAATTCCGCGTGTAGCAGTGAAATGCGTAGATATGCGGAGGAACACCGATGGCGAAGGCAATCCCCTG	False
TACGTAGGGTGCAAGCGTTAATCGGAATTACTGGGCGTAAAGCGTGCGCAGGCGGTATGTAAGACAGTTGTGAAATCCCCGGGCTCAACCTGGGAACTGCATCTGTGACTGCATAGCTAGAGTACGGTAGAGTGGGATGGAATTCCGCGT	False
TACGTAGGGGGCAAGCGTTATCCGGATTTACTGGGTGTAAAGGGAGCGTAGACGGCCATGCAAGCCTGGAGTGAAAGCCCGGGGCCCAACCCCGGGACTGCTCTGGGAACTGTGCGGCTGGAGTGCGGGAGGGGCAGGCGGAATTCCTGG	False
TACGTAGGTGGCAAGCGTTATCCGGATTTACTGGGTGTAAAGGGCGTGTAGGCGGGAAAGCAAGTCAGATGTGAAAACCATGGGCTCAACCTGTGGCCTGCATTTGAAACTGTTTTTCTTGAGTACTGGAGAGGCAGACGGACTTCCTAG	False
TACGAAGGGGTCTAGCGTTGTTCGGATTTACTGGGCGTAAAGCGCACGTAGGCGGATATTTAAGTCAGAGGTGAAATCCCAGGGCTCAACCCTGGAACTGCCTTTGATACTGGGTATCTAGAGTATGGAAGAGGTGAGTGGAATTCCGAG	False
TACGTAGGGTGCGAGCGTTGTCCGGAATTATTGGGCGTAAAGAGCTTGTAGGCGGTTTGTCGCGTCTGCTGTGAAAGACCGGGGCGTAACTCCGGTTCTGCAGTGGGTACGGGCAGACTAGAGTGTGGTAGGGGAGACTGGAATTCCTGG	False
TACGAAGGGTGCAAGCGTTAATCGGAATTACTGGGCGTAAAGCGCGCGTAGGTGGCTTGATAAGTTGGATGTGAAATCCCCGGGCTCAACCTGGGAACTGCATCCAAAACTGTCTGGCTAGAGTGTGGTAGAGGGTAGTGGAATTTCCAG	False
